balPayments,expDir,expWgt,hsCode,impDir,impWgt,statKor,year
-705145,0,0,0101101000,705145,2853,말(농가 사육용의 것에 한한다) ,2002.01
-46036,0,0,0101901010,46036,1500,경주말 ,2002.01
-396389,0,0,0102101000,396389,3766,젖소 ,2002.01
-72616,0,0,0103100000,72616,7272,번식용,2002.01
-47500,0,0,0103910000,47500,40,중량이 50킬로그램 미만인 것,2002.01
-94075,0,0,0105111000,94075,440,번식용,2002.01
105097,105097,3408,0105119000,0,0,기타,2002.01
-5636,0,0,0106001010,5636,42,개,2002.01
-147666,5712,133,0106110000,153378,2635,영장류,2002.01
-418,0,0,0106120000,418,25,"고래ㆍ돌고래류(고래목의 포유동물), 바다소(바다소목의 포유동물) ",2002.01
-289309,0,0,0106191000,289309,3824,개,2002.01
-13,0,0,0106192000,13,3,토끼,2002.01
2224,2224,400,0106193000,0,0,사슴,2002.01
-226436,1390,26,0106199000,227826,2637,기타,2002.01
-2367,0,0,0106201000,2367,85,뱀,2002.01
-101088,0,0,0106202000,101088,17480,자라,2002.01
-6055,0,0,0106209000,6055,150,기타,2002.01
4208,4208,63,0106390000,0,0,기타,2002.01
-471,0,0,0106901000,471,4,양서류,2002.01
-24494,0,0,0106902090,24494,2240,기타 ,2002.01
-24812,14076,557,0106903010,38888,3080,갯지렁이,2002.01
-4341,167,7,0106903090,4508,3,기타,2002.01
-2925,0,0,0106909000,2925,97,기타,2002.01
-207000,0,0,0101101000,207000,8500,말(농가 사육용의 것에 한한다) ,2002.02
-41184,0,0,0102101000,41184,1410,젖소 ,2002.02
-49133,26867,2500,0103100000,76000,3420,번식용,2002.02
-63585,0,0,0104201000,63585,4000,젖염소,2002.02
-123000,0,0,0105111000,123000,2840,번식용,2002.02
56493,56493,1771,0105119000,0,0,기타,2002.02
-1484,4016,96,0106110000,5500,20,영장류,2002.02
-259512,338,45,0106191000,259850,4852,개,2002.02
-174335,1392,30,0106199000,175727,3067,기타,2002.02
-5543,0,0,0106201000,5543,75,뱀,2002.02
-92522,0,0,0106202000,92522,15070,자라,2002.02
-16255,0,0,0106203000,16255,2385,거북,2002.02
-8331,0,0,0106209000,8331,125,기타,2002.02
6391,6391,100,0106390000,0,0,기타,2002.02
-5160,0,0,0106901000,5160,73,양서류,2002.02
-317934,0,0,0106902010,317934,9700,꿀벌 ,2002.02
-30977,0,0,0106902090,30977,2758,기타 ,2002.02
-16248,7617,375,0106903010,23865,1780,갯지렁이,2002.02
-3299,1147,48,0106903090,4446,3,기타,2002.02
-2089,0,0,0106909000,2089,7,기타,2002.02
-79970,0,0,0101101000,79970,4746,말(농가 사육용의 것에 한한다) ,2002.03
-33903,0,0,0101901010,33903,3500,경주말 ,2002.03
-20592,0,0,0102101000,20592,616,젖소 ,2002.03
-359552,0,0,0103100000,359552,39384,번식용,2002.03
-214613,0,0,0105111000,214613,2715,번식용,2002.03
95643,95643,3096,0105119000,0,0,기타,2002.03
-25565,0,0,0105191000,25565,93,오 리,2002.03
-9077,2466,57,0106110000,11543,85,영장류,2002.03
-720731,0,0,0106191000,720731,11044,개,2002.03
-159854,0,0,0106199000,159854,1472,기타,2002.03
-86710,0,0,0106202000,86710,13858,자라,2002.03
-42377,0,0,0106203000,42377,2366,거북,2002.03
-6066,0,0,0106209000,6066,23,기타,2002.03
5435,6235,93,0106390000,800,25,기타,2002.03
-274,0,0,0106901000,274,9,양서류,2002.03
-450546,0,0,0106902010,450546,13556,꿀벌 ,2002.03
-50204,0,0,0106902090,50204,4243,기타 ,2002.03
-1453,14147,652,0106903010,15600,1100,갯지렁이,2002.03
-1903,2528,213,0106903090,4431,3,기타,2002.03
-22444,0,0,0106909000,22444,867,기타,2002.03
-14101,9899,2400,0101101000,24000,1400,말(농가 사육용의 것에 한한다) ,2002.04
-104285,0,0,0101901010,104285,9000,경주말 ,2002.04
-24000,0,0,0101901090,24000,2400,기타 ,2002.04
-41173,0,0,0102101000,41173,771,젖소 ,2002.04
-123719,0,0,0103100000,123719,10755,번식용,2002.04
-338392,0,0,0105111000,338392,4096,번식용,2002.04
105097,105097,3500,0105119000,0,0,기타,2002.04
-49134,1298,31,0106110000,50432,543,영장류,2002.04
-742897,224,32,0106191000,743121,13548,개,2002.04
-166795,21331,190,0106199000,188126,2042,기타,2002.04
-5110,0,0,0106201000,5110,70,뱀,2002.04
-156810,0,0,0106202000,156810,23841,자라,2002.04
-18978,0,0,0106203000,18978,475,거북,2002.04
-23060,0,0,0106209000,23060,135,기타,2002.04
8698,10048,181,0106390000,1350,58,기타,2002.04
20147,20147,410,0106901000,0,0,양서류,2002.04
-27997,0,0,0106902090,27997,2869,기타 ,2002.04
4873,19885,890,0106903010,15012,971,갯지렁이,2002.04
-408,4060,368,0106903090,4468,3,기타,2002.04
-10186,0,0,0106909000,10186,495,기타,2002.04
-961072,0,0,0101901010,961072,42320,경주말 ,2002.05
-68258,0,0,0101901090,68258,1450,기타 ,2002.05
-93495,0,0,0103100000,93495,9076,번식용,2002.05
-115152,0,0,0105111000,115152,1663,번식용,2002.05
-90493,0,0,0105199000,90493,104,기타 ,2002.05
3412,3924,97,0106110000,512,9,영장류,2002.05
-971384,431,45,0106191000,971815,14968,개,2002.05
-242083,1392,35,0106199000,243475,2707,기타,2002.05
-6355,0,0,0106201000,6355,190,뱀,2002.05
-140476,0,0,0106202000,140476,20248,자라,2002.05
-19518,0,0,0106203000,19518,2558,거북,2002.05
-33080,0,0,0106209000,33080,520,기타,2002.05
-12900,0,0,0106320000,12900,5,앵무류[패럿류(parrots)ㆍ패러키트류(parakeets)ㆍ금강앵무류ㆍ유황앵무류를 포함한다],2002.05
6376,7380,191,0106390000,1004,36,기타,2002.05
12224,12695,419,0106901000,471,2,양서류,2002.05
-17584,0,0,0106902090,17584,1715,기타 ,2002.05
-3036,32518,1421,0106903010,35554,2966,갯지렁이,2002.05
-3849,708,64,0106903090,4557,3,기타,2002.05
-8530,0,0,0106909000,8530,260,기타,2002.05
-10337,0,0,0101101000,10337,480,말(농가 사육용의 것에 한한다) ,2002.06
-534871,0,0,0101901010,534871,16340,경주말 ,2002.06
-18901,0,0,0101901090,18901,6300,기타 ,2002.06
-8741,0,0,0101909000,8741,17500,기타 ,2002.06
-95300,0,0,0103100000,95300,6832,번식용,2002.06
-392636,0,0,0105111000,392636,2791,번식용,2002.06
17621,17621,550,0105119000,0,0,기타,2002.06
2732,2732,74,0106110000,0,0,영장류,2002.06
-613531,494,56,0106191000,614025,10350,개,2002.06
-175090,1444,40,0106199000,176534,2413,기타,2002.06
-10648,0,0,0106201000,10648,191,뱀,2002.06
-152947,0,0,0106202000,152947,19907,자라,2002.06
-3267,0,0,0106203000,3267,630,거북,2002.06
-48986,0,0,0106209000,48986,1886,기타,2002.06
-22300,0,0,0106310000,22300,35,맹금류,2002.06
2861,8265,142,0106390000,5404,46,기타,2002.06
1872,3224,200,0106901000,1352,9,양서류,2002.06
-11119,0,0,0106902090,11119,1062,기타 ,2002.06
-37032,23513,1043,0106903010,60545,5205,갯지렁이,2002.06
1572,1572,32,0106903020,0,0,실지렁이,2002.06
-4547,0,0,0106903090,4547,3,기타,2002.06
-3127,0,0,0106909000,3127,246,기타,2002.06
-30000,0,0,0101101000,30000,1500,말(농가 사육용의 것에 한한다) ,2002.07
-154161,0,0,0101901010,154161,10400,경주말 ,2002.07
-391790,0,0,0101901090,391790,6745,기타 ,2002.07
-277605,0,0,0102101000,277605,2100,젖소 ,2002.07
-1559101,0,0,0105111000,1559101,11552,번식용,2002.07
13000,13000,330,0105119000,0,0,기타,2002.07
-54936,0,0,0105191000,54936,124,오 리,2002.07
-629495,429,4,0106191000,629924,12960,개,2002.07
-8,0,0,0106192000,8,4,토끼,2002.07
-186634,0,0,0106199000,186634,2209,기타,2002.07
-5511,0,0,0106201000,5511,20,뱀,2002.07
-157306,0,0,0106202000,157306,22089,자라,2002.07
-26789,0,0,0106203000,26789,743,거북,2002.07
-33576,0,0,0106209000,33576,627,기타,2002.07
5613,5931,81,0106390000,318,21,기타,2002.07
636,995,50,0106901000,359,2,양서류,2002.07
-9350,0,0,0106902090,9350,600,기타 ,2002.07
-183630,19703,859,0106903010,203333,17188,갯지렁이,2002.07
-4759,0,0,0106903090,4759,3,기타,2002.07
-4433,0,0,0106909000,4433,358,기타,2002.07
-5000,0,0,0101101000,5000,500,말(농가 사육용의 것에 한한다) ,2002.08
-122794,0,0,0101901010,122794,4000,경주말 ,2002.08
-55331,0,0,0101901090,55331,3116,기타 ,2002.08
-45270,0,0,0102101000,45270,1030,젖소 ,2002.08
-199968,0,0,0103100000,199968,22460,번식용,2002.08
-55587,0,0,0105111000,55587,1274,번식용,2002.08
31000,31000,808,0105119000,0,0,기타,2002.08
-8057,0,0,0105999000,8057,188,기타,2002.08
1630,1630,68,0106110000,0,0,영장류,2002.08
-599012,0,0,0106191000,599012,10784,개,2002.08
-51,0,0,0106192000,51,2,토끼,2002.08
-177330,0,0,0106199000,177330,2327,기타,2002.08
-24370,0,0,0106201000,24370,243,뱀,2002.08
-170018,0,0,0106202000,170018,23456,자라,2002.08
-18472,0,0,0106203000,18472,1111,거북,2002.08
-49168,0,0,0106209000,49168,1655,기타,2002.08
-18207,0,0,0106320000,18207,126,앵무류[패럿류(parrots)ㆍ패러키트류(parakeets)ㆍ금강앵무류ㆍ유황앵무류를 포함한다],2002.08
4866,4866,84,0106390000,0,0,기타,2002.08
-457,0,0,0106901000,457,4,양서류,2002.08
-13541,0,0,0106902090,13541,987,기타 ,2002.08
-458006,30135,1400,0106903010,488141,37235,갯지렁이,2002.08
-9711,0,0,0106903090,9711,6,기타,2002.08
-1487,0,0,0106909000,1487,213,기타,2002.08
-142000,0,0,0101101000,142000,3600,말(농가 사육용의 것에 한한다) ,2002.09
-609528,0,0,0101901010,609528,26000,경주말 ,2002.09
-24898,0,0,0101901090,24898,23325,기타 ,2002.09
-5804,0,0,0101909000,5804,12000,기타 ,2002.09
-21593,0,0,0102101000,21593,670,젖소 ,2002.09
-119332,0,0,0105111000,119332,2343,번식용,2002.09
26054,26054,712,0105119000,0,0,기타,2002.09
2931,2931,70,0106110000,0,0,영장류,2002.09
-692181,0,0,0106191000,692181,11592,개,2002.09
-179279,0,0,0106199000,179279,2175,기타,2002.09
-12144,121,1,0106201000,12265,60,뱀,2002.09
-137026,0,0,0106202000,137026,18790,자라,2002.09
-47112,0,0,0106203000,47112,1405,거북,2002.09
-26850,0,0,0106209000,26850,338,기타,2002.09
-160,10840,214,0106390000,11000,70,기타,2002.09
-34,0,0,0106901000,34,1,양서류,2002.09
-21426,0,0,0106902090,21426,1666,기타 ,2002.09
-591719,14119,685,0106903010,605838,46084,갯지렁이,2002.09
-9824,0,0,0106903090,9824,5,기타,2002.09
-1575,0,0,0106909000,1575,240,기타,2002.09
-453642,0,0,0101901010,453642,8450,경주말 ,2002.10
-24700,49523,1000,0101901090,74223,40548,기타 ,2002.10
-63716,0,0,0102101000,63716,1886,젖소 ,2002.10
-745563,0,0,0102902000,745563,223511,육우 ,2002.10
-427829,0,0,0103100000,427829,26900,번식용,2002.10
-1121,0,0,0103920000,1121,125,중량이 50킬로그램 이상인 것,2002.10
-270840,0,0,0104209000,270840,67000,기타,2002.10
-625889,0,0,0105111000,625889,4914,번식용,2002.10
31000,31000,932,0105119000,0,0,기타,2002.10
-25200,0,0,0105921000,25200,357,종 계,2002.10
3676,3676,58,0106110000,0,0,영장류,2002.10
-1022220,0,0,0106191000,1022220,15144,개,2002.10
-178005,0,0,0106199000,178005,2301,기타,2002.10
-10644,0,0,0106201000,10644,31,뱀,2002.10
-164684,0,0,0106202000,164684,22419,자라,2002.10
-12886,0,0,0106203000,12886,887,거북,2002.10
-13845,0,0,0106209000,13845,181,기타,2002.10
4623,4799,73,0106390000,176,5,기타,2002.10
-1743,0,0,0106901000,1743,10,양서류,2002.10
7202,7202,256,0106902010,0,0,꿀벌 ,2002.10
-30096,0,0,0106902090,30096,2351,기타 ,2002.10
-192917,24851,1042,0106903010,217768,16277,갯지렁이,2002.10
-10559,0,0,0106903090,10559,7,기타,2002.10
-2683,0,0,0106909000,2683,218,기타,2002.10
-1579462,0,0,0101101000,1579462,17450,말(농가 사육용의 것에 한한다) ,2002.11
-219479,0,0,0101901010,219479,11900,경주말 ,2002.11
-37371,0,0,0101901090,37371,2470,기타 ,2002.11
-277930,0,0,0103100000,277930,22074,번식용,2002.11
-64680,0,0,0104201000,64680,6040,젖염소,2002.11
-91850,0,0,0104209000,91850,9310,기타,2002.11
-118658,0,0,0105111000,118658,2521,번식용,2002.11
8059,8059,240,0105119000,0,0,기타,2002.11
3514,3514,28,0106110000,0,0,영장류,2002.11
-819531,0,0,0106191000,819531,12648,개,2002.11
-200127,754,27,0106199000,200881,3112,기타,2002.11
-15430,0,0,0106201000,15430,717,뱀,2002.11
-107380,0,0,0106202000,107380,15904,자라,2002.11
-2635,0,0,0106203000,2635,10,거북,2002.11
-12725,0,0,0106209000,12725,166,기타,2002.11
570,832,21,0106390000,262,7,기타,2002.11
-2477,0,0,0106901000,2477,42,양서류,2002.11
-50864,0,0,0106902090,50864,2578,기타 ,2002.11
-94168,26621,851,0106903010,120789,10976,갯지렁이,2002.11
-3733,2929,100,0106903090,6662,14,기타,2002.11
-572,0,0,0106909000,572,60,기타,2002.11
-127735,0,0,0101101000,127735,9690,말(농가 사육용의 것에 한한다) ,2002.12
-396163,0,0,0101901010,396163,15190,경주말 ,2002.12
-25217,0,0,0101901090,25217,6320,기타 ,2002.12
-284911,0,0,0102101000,284911,6060,젖소 ,2002.12
-55200,0,0,0103100000,55200,3360,번식용,2002.12
-2190478,0,0,0105111000,2190478,15438,번식용,2002.12
1876,1876,14,0106110000,0,0,영장류,2002.12
-1011070,0,0,0106191000,1011070,16174,개,2002.12
-36,0,0,0106192000,36,4,토끼,2002.12
-173103,907,26,0106199000,174010,2768,기타,2002.12
-6502,0,0,0106201000,6502,112,뱀,2002.12
-95902,0,0,0106202000,95902,16227,자라,2002.12
-557,0,0,0106203000,557,50,거북,2002.12
-920,0,0,0106209000,920,20,기타,2002.12
-38500,0,0,0106310000,38500,41,맹금류,2002.12
3807,5642,100,0106390000,1835,75,기타,2002.12
-425,0,0,0106901000,425,30,양서류,2002.12
-47885,0,0,0106902090,47885,3103,기타 ,2002.12
-28932,8924,354,0106903010,37856,3192,갯지렁이,2002.12
618,618,20,0106903090,0,0,기타,2002.12
-4289,0,0,0106909000,4289,200,기타,2002.12
-32914341,1011537,36590,-,33925878,1474365,-,총계
-118287,0,0,0101101000,118287,7320,말(농가 사육용의 것에 한한다) ,2003.01
-10000,0,0,0101901010,10000,450,경주말 ,2003.01
-31738,0,0,0101901090,31738,12880,기타 ,2003.01
-153317,0,0,0102101000,153317,1000,젖소 ,2003.01
-101000,0,0,0103100000,101000,7190,번식용,2003.01
-58262,0,0,0105191000,58262,123,오 리,2003.01
3512,3512,31,0106110000,0,0,영장류,2003.01
-815235,0,0,0106191000,815235,12919,개,2003.01
-7584,0,0,0106192000,7584,100,토끼,2003.01
-156621,362,8,0106199000,156983,2058,기타,2003.01
-7441,0,0,0106201000,7441,129,뱀,2003.01
-112535,0,0,0106202000,112535,17150,자라,2003.01
0,0,0,0106203000,0,50,거북,2003.01
-24981,0,0,0106209000,24981,325,기타,2003.01
-586,0,0,0106320000,586,6,앵무류[패럿류(parrots)ㆍ패러키트류(parakeets)ㆍ금강앵무류ㆍ유황앵무류를 포함한다],2003.01
-1874,2092,57,0106390000,3966,106,기타,2003.01
-2120,0,0,0106901000,2120,16,양서류,2003.01
-57025,0,0,0106902090,57025,3272,기타 ,2003.01
-27037,4204,173,0106903010,31241,2394,갯지렁이,2003.01
-11613,0,0,0106903090,11613,26,기타,2003.01
-1992,0,0,0106909000,1992,152,기타,2003.01
-21664,0,0,0101901010,21664,1500,경주말 ,2003.02
-5281,0,0,0101901090,5281,3500,기타 ,2003.02
-620943,0,0,0102101000,620943,6140,젖소 ,2003.02
-216250,0,0,0103100000,216250,18423,번식용,2003.02
-31094,0,0,0103920000,31094,3600,중량이 50킬로그램 이상인 것,2003.02
21661,21661,696,0105119000,0,0,기타,2003.02
-87852,3930,32,0106110000,91782,310,영장류,2003.02
-685887,0,0,0106191000,685887,13463,개,2003.02
-239461,1094,25,0106199000,240555,3729,기타,2003.02
-1090,0,0,0106201000,1090,6,뱀,2003.02
-133802,0,0,0106202000,133802,19788,자라,2003.02
-20939,0,0,0106203000,20939,189,거북,2003.02
-7603,0,0,0106209000,7603,123,기타,2003.02
-700,0,0,0106320000,700,6,앵무류[패럿류(parrots)ㆍ패러키트류(parakeets)ㆍ금강앵무류ㆍ유황앵무류를 포함한다],2003.02
2155,2988,69,0106390000,833,12,기타,2003.02
-2494,0,0,0106901000,2494,11,양서류,2003.02
-69610,0,0,0106902090,69610,4054,기타 ,2003.02
-9076,9652,347,0106903010,18728,1366,갯지렁이,2003.02
-4145,0,0,0106903090,4145,2,기타,2003.02
-98,0,0,0106909000,98,1,기타,2003.02
-113000,0,0,0101101000,113000,16200,말(농가 사육용의 것에 한한다) ,2003.03
-211228,0,0,0101901010,211228,9050,경주말 ,2003.03
-51866,0,0,0101901090,51866,10650,기타 ,2003.03
-40831,0,0,0102101000,40831,907,젖소 ,2003.03
-725654,0,0,0102902000,725654,352299,육우 ,2003.03
-69795,0,0,0103100000,69795,6150,번식용,2003.03
-127500,0,0,0105111000,127500,1469,번식용,2003.03
105630,105630,3232,0105119000,0,0,기타,2003.03
4423,4423,33,0106110000,0,0,영장류,2003.03
-863816,0,0,0106191000,863816,14296,개,2003.03
-217443,1228,28,0106199000,218671,2932,기타,2003.03
-23137,0,0,0106201000,23137,54,뱀,2003.03
-132259,0,0,0106202000,132259,18141,자라,2003.03
0,0,0,0106203000,0,10,거북,2003.03
-24030,0,0,0106209000,24030,426,기타,2003.03
-8705,0,0,0106310000,8705,90,맹금류,2003.03
6700,7906,173,0106390000,1206,80,기타,2003.03
-4669,0,0,0106901000,4669,13,양서류,2003.03
-65489,0,0,0106902090,65489,4330,기타 ,2003.03
-4245,11387,520,0106903010,15632,1108,갯지렁이,2003.03
-6473,0,0,0106903090,6473,16,기타,2003.03
-8963,32,20,0106909000,8995,312,기타,2003.03
-58203,0,0,0101101000,58203,3500,말(농가 사육용의 것에 한한다) ,2003.04
-646138,0,0,0101901010,646138,24600,경주말 ,2003.04
-34987,0,0,0101901090,34987,13350,기타 ,2003.04
-831094,0,0,0102902000,831094,392009,육우 ,2003.04
47637,47637,1544,0105119000,0,0,기타,2003.04
-11525,0,0,0106110000,11525,25,영장류,2003.04
-893418,0,0,0106191000,893418,13915,개,2003.04
-238076,5830,124,0106199000,243906,3109,기타,2003.04
-8540,0,0,0106201000,8540,133,뱀,2003.04
-149888,0,0,0106202000,149888,21017,자라,2003.04
-19169,0,0,0106203000,19169,97,거북,2003.04
-22277,0,0,0106209000,22277,308,기타,2003.04
-3121,0,0,0106310000,3121,1,맹금류,2003.04
-1793,0,0,0106320000,1793,5,앵무류[패럿류(parrots)ㆍ패러키트류(parakeets)ㆍ금강앵무류ㆍ유황앵무류를 포함한다],2003.04
45094,45094,373,0106390000,0,0,기타,2003.04
7371,13134,418,0106901000,5763,45,양서류,2003.04
-47442,0,0,0106902090,47442,3448,기타 ,2003.04
-10937,11101,418,0106903010,22038,1492,갯지렁이,2003.04
-81,0,0,0106903020,81,6,실지렁이,2003.04
-4801,123,10,0106903090,4924,3,기타,2003.04
-6049,0,0,0106909000,6049,297,기타,2003.04
-59740,0,0,0101101000,59740,4700,말(농가 사육용의 것에 한한다) ,2003.05
-511525,0,0,0101901010,511525,12836,경주말 ,2003.05
-67598,0,0,0101901090,67598,30990,기타 ,2003.05
-75631,0,0,0101909000,75631,6000,기타 ,2003.05
-106920,0,0,0102101000,106920,8755,젖소 ,2003.05
-95617,0,0,0103100000,95617,11180,번식용,2003.05
13885,13885,420,0105119000,0,0,기타,2003.05
-99853,0,0,0105191000,99853,1254,오 리,2003.05
-17632,0,0,0106110000,17632,12,영장류,2003.05
-624177,3340,14,0106191000,627517,9867,개,2003.05
1112,1112,350,0106193000,0,0,사슴,2003.05
-221954,7305,133,0106199000,229259,6170,기타,2003.05
-8427,0,0,0106201000,8427,71,뱀,2003.05
-138574,0,0,0106202000,138574,17918,자라,2003.05
-8989,0,0,0106203000,8989,48,거북,2003.05
-19834,0,0,0106209000,19834,190,기타,2003.05
-16282,0,0,0106320000,16282,169,앵무류[패럿류(parrots)ㆍ패러키트류(parakeets)ㆍ금강앵무류ㆍ유황앵무류를 포함한다],2003.05
8058,8058,128,0106390000,0,0,기타,2003.05
9429,11980,453,0106901000,2551,11,양서류,2003.05
-27328,0,0,0106902090,27328,1263,기타 ,2003.05
-21482,31969,1098,0106903010,53451,4816,갯지렁이,2003.05
-6526,0,0,0106903090,6526,16,기타,2003.05
-2392,0,0,0106909000,2392,195,기타,2003.05
-16000,0,0,0101101000,16000,850,말(농가 사육용의 것에 한한다) ,2003.06
-356339,0,0,0101901010,356339,11961,경주말 ,2003.06
-33398,0,0,0101901090,33398,21300,기타 ,2003.06
-876413,0,0,0102902000,876413,389517,육우 ,2003.06
-141475,0,0,0103100000,141475,13044,번식용,2003.06
-987953,0,0,0105111000,987953,4443,번식용,2003.06
1970,1970,23,0106110000,0,0,영장류,2003.06
-560950,1366,51,0106191000,562316,9454,개,2003.06
-3892,0,0,0106192000,3892,56,토끼,2003.06
-195829,4505,83,0106199000,200334,2545,기타,2003.06
-4626,0,0,0106201000,4626,140,뱀,2003.06
-151850,0,0,0106202000,151850,19697,자라,2003.06
-12845,0,0,0106203000,12845,33,거북,2003.06
-20657,0,0,0106209000,20657,337,기타,2003.06
-22347,0,0,0106320000,22347,334,앵무류[패럿류(parrots)ㆍ패러키트류(parakeets)ㆍ금강앵무류ㆍ유황앵무류를 포함한다],2003.06
-425,6975,130,0106390000,7400,60,기타,2003.06
6897,9848,275,0106901000,2951,30,양서류,2003.06
-13969,0,0,0106902090,13969,1031,기타 ,2003.06
-152558,14299,582,0106903010,166857,17425,갯지렁이,2003.06
-6119,0,0,0106903090,6119,6,기타,2003.06
-1526,0,0,0106909000,1526,220,기타,2003.06
-516338,0,0,0101901010,516338,6100,경주말 ,2003.07
-6600,0,0,0101901090,6600,3000,기타 ,2003.07
-362387,0,0,0102101000,362387,12208,젖소 ,2003.07
-99573,0,0,0103100000,99573,3390,번식용,2003.07
-701168,0,0,0105111000,701168,2637,번식용,2003.07
94249,94249,2830,0105119000,0,0,기타,2003.07
-18149,0,0,0105921000,18149,155,종 계,2003.07
2418,2418,40,0105999000,0,0,기타,2003.07
-537444,4482,30,0106191000,541926,8124,개,2003.07
-226196,4885,139,0106199000,231081,3076,기타,2003.07
-37819,0,0,0106201000,37819,1465,뱀,2003.07
-186607,0,0,0106202000,186607,24244,자라,2003.07
-22892,0,0,0106203000,22892,198,거북,2003.07
-12455,0,0,0106209000,12455,154,기타,2003.07
-23073,0,0,0106320000,23073,20,앵무류[패럿류(parrots)ㆍ패러키트류(parakeets)ㆍ금강앵무류ㆍ유황앵무류를 포함한다],2003.07
13855,13855,107,0106390000,0,0,기타,2003.07
14478,15920,390,0106901000,1442,29,양서류,2003.07
-8489,0,0,0106902090,8489,592,기타 ,2003.07
-201702,19232,768,0106903010,220934,18974,갯지렁이,2003.07
-7690,0,0,0106903090,7690,23,기타,2003.07
-1011,0,0,0106909000,1011,165,기타,2003.07
-30000,0,0,0101101000,30000,2510,말(농가 사육용의 것에 한한다) ,2003.08
-684445,0,0,0101901010,684445,23590,경주말 ,2003.08
-14962,0,0,0101901090,14962,7500,기타 ,2003.08
-3803,0,0,0101909000,3803,3000,기타 ,2003.08
-133910,0,0,0102101000,133910,3092,젖소 ,2003.08
-30800,0,0,0103100000,30800,4480,번식용,2003.08
-65764,0,0,0105111000,65764,704,번식용,2003.08
16497,16497,480,0105119000,0,0,기타,2003.08
-61411,0,0,0105191000,61411,123,오 리,2003.08
-241624,1001,15,0106191000,242625,4411,개,2003.08
-25,0,0,0106192000,25,3,토끼,2003.08
-143848,11840,248,0106199000,155688,1901,기타,2003.08
-15274,0,0,0106201000,15274,75,뱀,2003.08
-105423,0,0,0106202000,105423,13077,자라,2003.08
-39190,0,0,0106203000,39190,280,거북,2003.08
-14134,0,0,0106209000,14134,222,기타,2003.08
4840,4840,67,0106390000,0,0,기타,2003.08
6317,7164,175,0106901000,847,3,양서류,2003.08
-17952,0,0,0106902090,17952,1290,기타 ,2003.08
-255130,22147,1000,0106903010,277277,24608,갯지렁이,2003.08
-12527,0,0,0106903090,12527,24,기타,2003.08
-3570,1175,31,0106909000,4745,69,기타,2003.08
-367747,0,0,0101901010,367747,9950,경주말 ,2003.09
-112400,0,0,0101901090,112400,7750,기타 ,2003.09
-507320,0,0,0103100000,507320,9230,번식용,2003.09
-268840,0,0,0104201000,268840,56991,젖염소,2003.09
-169950,0,0,0104209000,169950,9274,기타,2003.09
40664,40664,1196,0105119000,0,0,기타,2003.09
-343601,2127,35,0106191000,345728,6477,개,2003.09
-206531,13761,442,0106199000,220292,6767,기타,2003.09
-9864,0,0,0106201000,9864,72,뱀,2003.09
-105713,0,0,0106202000,105713,13002,자라,2003.09
-19827,0,0,0106203000,19827,334,거북,2003.09
-11832,0,0,0106209000,11832,204,기타,2003.09
2987,3576,75,0106390000,589,35,기타,2003.09
10046,12736,310,0106901000,2690,14,양서류,2003.09
-21793,0,0,0106902090,21793,1764,기타 ,2003.09
-212102,37195,1184,0106903010,249297,24106,갯지렁이,2003.09
-1818,0,0,0106909000,1818,200,기타,2003.09
-266338,0,0,0101901010,266338,4807,경주말 ,2003.10
-44710,0,0,0101901090,44710,43820,기타 ,2003.10
-761178,0,0,0103100000,761178,13245,번식용,2003.10
-628132,0,0,0105111000,628132,3264,번식용,2003.10
29658,29658,952,0105119000,0,0,기타,2003.10
-316019,2807,73,0106191000,318826,4711,개,2003.10
-168,0,0,0106192000,168,1,토끼,2003.10
-221703,11880,316,0106199000,233583,2239,기타,2003.10
-9221,0,0,0106201000,9221,81,뱀,2003.10
-129858,0,0,0106202000,129858,15257,자라,2003.10
-20986,0,0,0106203000,20986,882,거북,2003.10
-15289,0,0,0106209000,15289,331,기타,2003.10
4893,5759,93,0106390000,866,40,기타,2003.10
-4090,0,0,0106901000,4090,33,양서류,2003.10
-23785,0,0,0106902090,23785,1933,기타 ,2003.10
-167858,23454,991,0106903010,191312,20562,갯지렁이,2003.10
-7381,0,0,0106903090,7381,18,기타,2003.10
-4330,0,0,0106909000,4330,114,기타,2003.10
-3180,0,0,0101101000,3180,490,말(농가 사육용의 것에 한한다) ,2003.11
-166276,0,0,0101901010,166276,5357,경주말 ,2003.11
-12721,0,0,0101901090,12721,1499,기타 ,2003.11
-752400,0,0,0103100000,752400,4620,번식용,2003.11
-72000,0,0,0105111000,72000,95,번식용,2003.11
36145,36145,1196,0105119000,0,0,기타,2003.11
-23677,0,0,0106110000,23677,40,영장류,2003.11
-267057,5586,77,0106191000,272643,4090,개,2003.11
-130400,42500,454,0106199000,172900,1365,기타,2003.11
-10556,0,0,0106201000,10556,114,뱀,2003.11
-86628,0,0,0106202000,86628,12001,자라,2003.11
-21231,0,0,0106203000,21231,947,거북,2003.11
-10419,0,0,0106209000,10419,302,기타,2003.11
-5251,0,0,0106310000,5251,8,맹금류,2003.11
4113,4113,76,0106390000,0,0,기타,2003.11
4836,5971,200,0106901000,1135,5,양서류,2003.11
-21841,0,0,0106902090,21841,1806,기타 ,2003.11
-78689,18090,740,0106903010,96779,9648,갯지렁이,2003.11
-7824,0,0,0106903090,7824,19,기타,2003.11
727,1033,20,0106909000,306,30,기타,2003.11
-969670,0,0,0101101000,969670,11750,말(농가 사육용의 것에 한한다) ,2003.12
-432085,0,0,0101901010,432085,10450,경주말 ,2003.12
-28837,0,0,0101901090,28837,1990,기타 ,2003.12
-646141,0,0,0102101000,646141,4588,젖소 ,2003.12
-552702,0,0,0102902000,552702,307423,육우 ,2003.12
-166705,0,0,0103100000,166705,6998,번식용,2003.12
-753732,0,0,0105111000,753732,3849,번식용,2003.12
45820,45820,1296,0105119000,0,0,기타,2003.12
-229477,6216,49,0106191000,235693,4189,개,2003.12
-189369,14711,447,0106199000,204080,1524,기타,2003.12
-10334,0,0,0106201000,10334,166,뱀,2003.12
-96762,0,0,0106202000,96762,14191,자라,2003.12
-19623,0,0,0106203000,19623,261,거북,2003.12
-4999,0,0,0106209000,4999,110,기타,2003.12
3005,3157,53,0106390000,152,5,기타,2003.12
-2296,0,0,0106901000,2296,77,양서류,2003.12
-35241,0,0,0106902090,35241,2417,기타 ,2003.12
-20140,11710,478,0106903010,31850,2704,갯지렁이,2003.12
-5662,0,0,0106909000,5662,165,기타,2003.12
-30270143,1018006,29141,-,31288149,2517043,-,총계
-13042,0,0,0101101000,13042,400,말(농가 사육용의 것에 한한다) ,2004.01
-99601,0,0,0101901010,99601,2000,경주말 ,2004.01
-182947,0,0,0101901090,182947,41680,기타 ,2004.01
-368520,0,0,0102902000,368520,136489,육우 ,2004.01
-37788,0,0,0103100000,37788,3562,번식용,2004.01
-7504,0,0,0105111000,7504,500,번식용,2004.01
-138886,2635,98,0106191000,141521,2733,개,2004.01
-195452,8720,247,0106199000,204172,1617,기타,2004.01
-263,0,0,0106201000,263,4,뱀,2004.01
-93238,0,0,0106202000,93238,15765,자라,2004.01
-23520,0,0,0106203000,23520,2802,거북,2004.01
-12829,0,0,0106209000,12829,337,기타,2004.01
-250,0,0,0106320000,250,12,앵무류[패럿류(parrots)ㆍ패러키트류(parakeets)ㆍ금강앵무류ㆍ유황앵무류를 포함한다],2004.01
-3185,0,0,0106390000,3185,100,기타,2004.01
-732,0,0,0106901000,732,2,양서류,2004.01
-46700,0,0,0106902090,46700,3421,기타 ,2004.01
-13350,17775,752,0106903010,31125,2323,갯지렁이,2004.01
-5599,0,0,0106903090,5599,3,기타,2004.01
-7273,0,0,0106909000,7273,189,기타,2004.01
-20000,0,0,0101101000,20000,500,말(농가 사육용의 것에 한한다) ,2004.02
-213167,0,0,0101901010,213167,8500,경주말 ,2004.02
-102040,0,0,0101901090,102040,29400,기타 ,2004.02
-12682,0,0,0101909000,12682,6487,기타 ,2004.02
-708890,0,0,0102902000,708890,262552,육우 ,2004.02
-50160,0,0,0103100000,50160,3425,번식용,2004.02
-143048,1538,14,0106191000,144586,2544,개,2004.02
-2891,0,0,0106192000,2891,40,토끼,2004.02
-190486,11397,245,0106199000,201883,1726,기타,2004.02
-5188,0,0,0106201000,5188,64,뱀,2004.02
-87669,0,0,0106202000,87669,15105,자라,2004.02
-31233,0,0,0106203000,31233,569,거북,2004.02
-20640,0,0,0106209000,20640,257,기타,2004.02
-6853,0,0,0106901000,6853,36,양서류,2004.02
-51335,0,0,0106902090,51335,4241,기타 ,2004.02
-26113,5696,240,0106903010,31809,2678,갯지렁이,2004.02
-8511,0,0,0106903090,8511,19,기타,2004.02
-4683,0,0,0106909000,4683,19,기타,2004.02
-22180,0,0,0101101000,22180,3250,말(농가 사육용의 것에 한한다) ,2004.03
-468439,0,0,0101901010,468439,10250,경주말 ,2004.03
-144383,0,0,0101901090,144383,41960,기타 ,2004.03
-1140615,0,0,0102902000,1140615,422450,육우 ,2004.03
-233274,0,0,0103100000,233274,17346,번식용,2004.03
-132273,0,0,0105111000,132273,2175,번식용,2004.03
-2400,0,0,0106110000,2400,80,영장류,2004.03
-194267,1388,16,0106191000,195655,3140,개,2004.03
-193920,12751,338,0106199000,206671,1593,기타,2004.03
-3940,0,0,0106201000,3940,5,뱀,2004.03
-116793,0,0,0106202000,116793,18333,자라,2004.03
-15600,0,0,0106203000,15600,784,거북,2004.03
-8047,0,0,0106209000,8047,177,기타,2004.03
-45061,0,0,0106390000,45061,250,기타,2004.03
-4247,0,0,0106901000,4247,146,양서류,2004.03
-64880,0,0,0106902090,64880,5096,기타 ,2004.03
-64886,12973,585,0106903010,77859,8194,갯지렁이,2004.03
-6259,0,0,0106909000,6259,161,기타,2004.03
-858567,0,0,0101901010,858567,24975,경주말 ,2004.04
-173608,0,0,0101901090,173608,16050,기타 ,2004.04
-224440,0,0,0103100000,224440,11360,번식용,2004.04
-251368,0,0,0105111000,251368,2199,번식용,2004.04
-151983,1739,16,0106191000,153722,3910,개,2004.04
-258584,12693,320,0106199000,271277,2338,기타,2004.04
-15407,0,0,0106201000,15407,95,뱀,2004.04
-148249,0,0,0106202000,148249,21938,자라,2004.04
-7458,0,0,0106203000,7458,615,거북,2004.04
-28012,0,0,0106209000,28012,181,기타,2004.04
6790,8835,364,0106901000,2045,20,양서류,2004.04
-44426,0,0,0106902090,44426,3403,기타 ,2004.04
30845,93205,2539,0106903010,62360,6181,갯지렁이,2004.04
-180,0,0,0106903020,180,4,실지렁이,2004.04
-8298,0,0,0106903090,8298,23,기타,2004.04
-2771,3042,39,0106909000,5813,187,기타,2004.04
-1195712,0,0,0101901010,1195712,34810,경주말 ,2004.05
-308163,0,0,0101901090,308163,29750,기타 ,2004.05
-44400,0,0,0103100000,44400,4500,번식용,2004.05
-228480,0,0,0105111000,228480,2600,번식용,2004.05
7640,7640,99,0106110000,0,0,영장류,2004.05
-71315,0,0,0106191000,71315,1815,개,2004.05
-183827,6783,208,0106199000,190610,1730,기타,2004.05
-4965,0,0,0106201000,4965,41,뱀,2004.05
-139586,0,0,0106202000,139586,20063,자라,2004.05
-24007,0,0,0106203000,24007,292,거북,2004.05
-15396,0,0,0106209000,15396,98,기타,2004.05
-11200,0,0,0106390000,11200,98,기타,2004.05
-1632,2388,100,0106901000,4020,78,양서류,2004.05
-27151,0,0,0106902090,27151,1810,기타 ,2004.05
-11986,52165,1613,0106903010,64151,5508,갯지렁이,2004.05
-5629,0,0,0106903090,5629,3,기타,2004.05
-6838,0,0,0106909000,6838,100,기타,2004.05
-232822,0,0,0101101000,232822,5760,말(농가 사육용의 것에 한한다) ,2004.06
-2463362,0,0,0101901010,2463362,55400,경주말 ,2004.06
-103782,0,0,0101901090,103782,7050,기타 ,2004.06
-184963,0,0,0103100000,184963,14282,번식용,2004.06
-129389,0,0,0103920000,129389,7040,중량이 50킬로그램 이상인 것,2004.06
-67027,4273,89,0106110000,71300,114,영장류,2004.06
-94326,1565,111,0106191000,95891,1981,개,2004.06
-243445,5444,122,0106199000,248889,2017,기타,2004.06
-3538,0,0,0106201000,3538,10,뱀,2004.06
-154140,0,0,0106202000,154140,22124,자라,2004.06
-4278,0,0,0106203000,4278,36,거북,2004.06
-11944,0,0,0106209000,11944,135,기타,2004.06
-3120,0,0,0106390000,3120,50,기타,2004.06
-4846,1910,74,0106901000,6756,53,양서류,2004.06
-29848,0,0,0106902090,29848,2103,기타 ,2004.06
-117190,30469,1069,0106903010,147659,15014,갯지렁이,2004.06
-8321,0,0,0106903090,8321,23,기타,2004.06
-10254,0,0,0106909000,10254,227,기타,2004.06
-97030,0,0,0101101000,97030,1350,말(농가 사육용의 것에 한한다) ,2004.07
-1748398,0,0,0101901010,1748398,27150,경주말 ,2004.07
-197418,0,0,0101901090,197418,1800,기타 ,2004.07
-112000,0,0,0103100000,112000,8476,번식용,2004.07
-880527,0,0,0105111000,880527,4335,번식용,2004.07
-38922,0,0,0105191000,38922,283,오 리,2004.07
759,759,15,0106110000,0,0,영장류,2004.07
-137871,9680,59,0106191000,147551,2860,개,2004.07
-5860,0,0,0106192000,5860,53,토끼,2004.07
-219126,8234,161,0106199000,227360,2171,기타,2004.07
-42166,0,0,0106201000,42166,371,뱀,2004.07
-132194,0,0,0106202000,132194,20376,자라,2004.07
-36271,0,0,0106203000,36271,309,거북,2004.07
-99539,0,0,0106209000,99539,7381,기타,2004.07
-10334,0,0,0106901000,10334,60,양서류,2004.07
-7373,0,0,0106902090,7373,403,기타 ,2004.07
-153429,34595,1144,0106903010,188024,18694,갯지렁이,2004.07
-8375,0,0,0106903090,8375,23,기타,2004.07
-3451,0,0,0106909000,3451,101,기타,2004.07
-60859,0,0,0101101000,60859,1000,말(농가 사육용의 것에 한한다) ,2004.08
-1039495,0,0,0101901010,1039495,21380,경주말 ,2004.08
-331634,0,0,0101901090,331634,7300,기타 ,2004.08
-165184,0,0,0103100000,165184,16395,번식용,2004.08
-221393,0,0,0105111000,221393,1350,번식용,2004.08
-73482,0,0,0105191000,73482,563,오 리,2004.08
-101102,3208,23,0106191000,104310,2154,개,2004.08
-230755,9936,269,0106199000,240691,2498,기타,2004.08
-3374,0,0,0106201000,3374,84,뱀,2004.08
-132713,0,0,0106202000,132713,19315,자라,2004.08
-89522,0,0,0106203000,89522,529,거북,2004.08
-20715,0,0,0106209000,20715,181,기타,2004.08
-9978,0,0,0106390000,9978,4,기타,2004.08
-2295,0,0,0106901000,2295,66,양서류,2004.08
-13170,0,0,0106902090,13170,968,기타 ,2004.08
-200040,35811,1087,0106903010,235851,24675,갯지렁이,2004.08
-5651,0,0,0106909000,5651,83,기타,2004.08
-241050,0,0,0101101000,241050,4000,말(농가 사육용의 것에 한한다) ,2004.09
-75206,0,0,0101901010,75206,4100,경주말 ,2004.09
-305885,0,0,0101901090,305885,15350,기타 ,2004.09
-223111,0,0,0103100000,223111,11764,번식용,2004.09
-40917,0,0,0105191000,40917,330,오 리,2004.09
-8350,0,0,0106110000,8350,17,영장류,2004.09
-67836,9578,745,0106191000,77414,1742,개,2004.09
-713,0,0,0106192000,713,12,토끼,2004.09
-194886,16926,402,0106199000,211812,1606,기타,2004.09
-3186,0,0,0106201000,3186,62,뱀,2004.09
-115389,0,0,0106202000,115389,16763,자라,2004.09
-7501,0,0,0106203000,7501,48,거북,2004.09
-2195,0,0,0106209000,2195,18,기타,2004.09
-5897,0,0,0106901000,5897,36,양서류,2004.09
-35126,0,0,0106902090,35126,1819,기타 ,2004.09
-212399,47384,1277,0106903010,259783,27621,갯지렁이,2004.09
-8181,0,0,0106903090,8181,23,기타,2004.09
-7030,0,0,0106909000,7030,91,기타,2004.09
-88955,0,0,0101101000,88955,2700,말(농가 사육용의 것에 한한다) ,2004.10
-390853,0,0,0101901010,390853,2300,경주말 ,2004.10
-219159,0,0,0101901090,219159,17760,기타 ,2004.10
-479553,0,0,0103100000,479553,30273,번식용,2004.10
-17270,0,0,0103920000,17270,375,중량이 50킬로그램 이상인 것,2004.10
-105307,0,0,0105191000,105307,817,오 리,2004.10
-6680,0,0,0106110000,6680,14,영장류,2004.10
-57635,10694,238,0106191000,68329,2141,개,2004.10
-34,0,0,0106192000,34,2,토끼,2004.10
-23090,0,0,0106194000,23090,509,곰,2004.10
-217633,10746,253,0106199000,228379,1642,기타,2004.10
-5250,0,0,0106201000,5250,28,뱀,2004.10
-129418,0,0,0106202000,129418,19042,자라,2004.10
-21959,0,0,0106203000,21959,326,거북,2004.10
-10337,0,0,0106209000,10337,112,기타,2004.10
-77189,2010,33,0106390000,79199,30,기타,2004.10
-2080,0,0,0106901000,2080,50,양서류,2004.10
-29090,0,0,0106902090,29090,1801,기타 ,2004.10
-187394,20524,652,0106903010,207918,24596,갯지렁이,2004.10
-5681,0,0,0106903090,5681,2,기타,2004.10
-11306,0,0,0106909000,11306,155,기타,2004.10
-4330045,0,0,0101901010,4330045,28207,경주말 ,2004.11
-251952,0,0,0101901090,251952,13970,기타 ,2004.11
-406214,0,0,0103100000,406214,20627,번식용,2004.11
-407925,0,0,0105111000,407925,585,번식용,2004.11
-134327,0,0,0105191000,134327,1027,오 리,2004.11
-69580,12104,674,0106191000,81684,1969,개,2004.11
-221725,8748,189,0106199000,230473,1884,기타,2004.11
-361,0,0,0106201000,361,2,뱀,2004.11
-102427,0,0,0106202000,102427,16117,자라,2004.11
-9506,0,0,0106203000,9506,388,거북,2004.11
-15233,0,0,0106209000,15233,146,기타,2004.11
-21470,7006,77,0106390000,28476,112,기타,2004.11
-1367,0,0,0106901000,1367,5,양서류,2004.11
-34244,0,0,0106902090,34244,2126,기타 ,2004.11
-117065,36682,1054,0106903010,153747,16853,갯지렁이,2004.11
-5867,0,0,0106903090,5867,3,기타,2004.11
-3616,0,0,0106909000,3616,48,기타,2004.11
-507614,0,0,0101101000,507614,13700,말(농가 사육용의 것에 한한다) ,2004.12
-1110264,0,0,0101901010,1110264,18930,경주말 ,2004.12
-195845,0,0,0101901090,195845,26730,기타 ,2004.12
-288113,195225,490,0103100000,483338,28332,번식용,2004.12
-1144751,0,0,0105111000,1144751,5672,번식용,2004.12
-41890,0,0,0105191000,41890,300,오 리,2004.12
-10020,0,0,0106110000,10020,21,영장류,2004.12
-90968,14226,887,0106191000,105194,2699,개,2004.12
-160810,9597,278,0106199000,170407,1542,기타,2004.12
-3452,0,0,0106201000,3452,20,뱀,2004.12
-100274,0,0,0106202000,100274,15796,자라,2004.12
-14616,0,0,0106203000,14616,658,거북,2004.12
-2677,0,0,0106209000,2677,26,기타,2004.12
-16591,0,0,0106320000,16591,15,앵무류[패럿류(parrots)ㆍ패러키트류(parakeets)ㆍ금강앵무류ㆍ유황앵무류를 포함한다],2004.12
-28236,18535,75,0106390000,46771,35,기타,2004.12
-5197,0,0,0106901000,5197,22,양서류,2004.12
-57304,0,0,0106902090,57304,3509,기타 ,2004.12
-78240,14865,467,0106903010,93105,10291,갯지렁이,2004.12
-8601,0,0,0106903090,8601,20,기타,2004.12
-8699,0,0,0106909000,8699,291,기타,2004.12
-34351394,844097,19845,-,35195491,2035181,-,총계
-46000,0,0,0101101000,46000,2000,말(농가 사육용의 것에 한한다) ,2005.01
-112286,0,0,0101901010,112286,1800,경주말 ,2005.01
-223310,0,0,0101901090,223310,34840,기타 ,2005.01
-95263,0,0,0103100000,95263,5630,번식용,2005.01
-266560,0,0,0105111000,266560,3000,번식용,2005.01
-389604,0,0,0106110000,389604,422,영장류,2005.01
-53117,17326,1312,0106191000,70443,2187,개,2005.01
-230320,15792,313,0106199000,246112,2131,기타,2005.01
-2292,0,0,0106201000,2292,9,뱀,2005.01
-99413,0,0,0106202000,99413,15650,자라,2005.01
-22744,0,0,0106203000,22744,282,거북,2005.01
-922,0,0,0106209000,922,10,기타,2005.01
-22062,0,0,0106310000,22062,12,맹금류,2005.01
-16200,0,0,0106390000,16200,10,기타,2005.01
-847,0,0,0106901000,847,80,양서류,2005.01
-37978,0,0,0106902090,37978,2811,기타 ,2005.01
-26234,5100,209,0106903010,31334,2708,갯지렁이,2005.01
-27834,0,0,0106909000,27834,129,기타,2005.01
-67500,0,0,0101101000,67500,1400,말(농가 사육용의 것에 한한다) ,2005.02
-367512,0,0,0101901010,367512,6097,경주말 ,2005.02
116739,405913,14400,0103100000,289174,21038,번식용,2005.02
-80644,8110,298,0106191000,88754,1996,개,2005.02
-286072,8583,228,0106199000,294655,2845,기타,2005.02
-1698,0,0,0106201000,1698,6,뱀,2005.02
-91497,0,0,0106202000,91497,17017,자라,2005.02
-34476,0,0,0106203000,34476,2297,거북,2005.02
-2486,0,0,0106209000,2486,7,기타,2005.02
-23120,0,0,0106310000,23120,10,맹금류,2005.02
-8933,0,0,0106320000,8933,6,앵무류[패럿류(parrots)ㆍ패러키트류(parakeets)ㆍ금강앵무류ㆍ유황앵무류를 포함한다],2005.02
-2524,0,0,0106901000,2524,6,양서류,2005.02
-31852,0,0,0106902090,31852,2348,기타 ,2005.02
-21383,4139,147,0106903010,25522,2233,갯지렁이,2005.02
-8447,0,0,0106903090,8447,20,기타,2005.02
-24342,0,0,0106909000,24342,230,기타,2005.02
-3862247,183,160,0101101000,3862430,4400,말(농가 사육용의 것에 한한다) ,2005.03
-306801,0,0,0101901010,306801,5490,경주말 ,2005.03
-24195,0,0,0101901090,24195,1890,기타 ,2005.03
-51411,0,0,0105191000,51411,451,오 리,2005.03
15331,83195,1256,0106191000,67864,2360,개,2005.03
-21,0,0,0106192000,21,1,토끼,2005.03
-321507,13470,320,0106199000,334977,3345,기타,2005.03
-1224,0,0,0106201000,1224,8,뱀,2005.03
-100800,0,0,0106202000,100800,16430,자라,2005.03
-16483,0,0,0106203000,16483,835,거북,2005.03
-3524,0,0,0106209000,3524,26,기타,2005.03
-33200,0,0,0106320000,33200,28,앵무류[패럿류(parrots)ㆍ패러키트류(parakeets)ㆍ금강앵무류ㆍ유황앵무류를 포함한다],2005.03
4218,5202,65,0106390000,984,21,기타,2005.03
-1874,0,0,0106901000,1874,17,양서류,2005.03
-57202,0,0,0106902090,57202,3569,기타 ,2005.03
-30706,8200,337,0106903010,38906,3523,갯지렁이,2005.03
-6081,0,0,0106903090,6081,2,기타,2005.03
-7400,0,0,0106909000,7400,149,기타,2005.03
-121877,0,0,0101101000,121877,3200,말(농가 사육용의 것에 한한다) ,2005.04
417717,648917,500,0101901010,231200,4780,경주말 ,2005.04
-19920,0,0,0101901090,19920,12000,기타 ,2005.04
-13858,0,0,0101909000,13858,600,기타 ,2005.04
35673,155426,200,0103100000,119753,6780,번식용,2005.04
-245700,0,0,0105111000,245700,2500,번식용,2005.04
-230696,0,0,0105191000,230696,1992,오 리,2005.04
-56403,18260,951,0106191000,74663,2343,개,2005.04
-279406,13912,318,0106199000,293318,2813,기타,2005.04
-9116,0,0,0106201000,9116,83,뱀,2005.04
-111456,0,0,0106202000,111456,17892,자라,2005.04
-26539,0,0,0106203000,26539,795,거북,2005.04
-2824,0,0,0106209000,2824,34,기타,2005.04
-3200,0,0,0106320000,3200,10,앵무류[패럿류(parrots)ㆍ패러키트류(parakeets)ㆍ금강앵무류ㆍ유황앵무류를 포함한다],2005.04
6110,6110,88,0106390000,0,0,기타,2005.04
-152,5254,150,0106901000,5406,69,양서류,2005.04
-69938,0,0,0106902090,69938,5404,기타 ,2005.04
-78240,19539,647,0106903010,97779,9942,갯지렁이,2005.04
-8476,0,0,0106903090,8476,19,기타,2005.04
-6663,0,0,0106909000,6663,414,기타,2005.04
15844,15844,1155,0101901010,0,0,경주말 ,2005.05
-1263825,0,0,0101901090,1263825,5900,기타 ,2005.05
-788971,0,0,0102902000,788971,394747,육우 ,2005.05
-430688,0,0,0103100000,430688,28641,번식용,2005.05
-74205,0,0,0103920000,74205,3216,중량이 50킬로그램 이상인 것,2005.05
-517482,0,0,0105111000,517482,3700,번식용,2005.05
-78483,0,0,0105191000,78483,641,오 리,2005.05
-78170,30891,2770,0106191000,109061,2541,개,2005.05
-243011,14421,280,0106199000,257432,2368,기타,2005.05
-8838,0,0,0106201000,8838,125,뱀,2005.05
-122578,0,0,0106202000,122578,18279,자라,2005.05
-22898,0,0,0106203000,22898,220,거북,2005.05
-9408,0,0,0106209000,9408,117,기타,2005.05
-12000,0,0,0106310000,12000,8,맹금류,2005.05
-4000,0,0,0106320000,4000,11,앵무류[패럿류(parrots)ㆍ패러키트류(parakeets)ㆍ금강앵무류ㆍ유황앵무류를 포함한다],2005.05
3536,3536,45,0106390000,0,0,기타,2005.05
10174,12736,418,0106901000,2562,26,양서류,2005.05
-30095,0,0,0106902090,30095,2049,기타 ,2005.05
-114756,21877,746,0106903010,136633,13514,갯지렁이,2005.05
-7812,0,0,0106909000,7812,446,기타,2005.05
-173582,0,0,0101101000,173582,2700,말(농가 사육용의 것에 한한다) ,2005.06
-3112807,0,0,0101901010,3112807,44750,경주말 ,2005.06
-429887,0,0,0101901090,429887,21140,기타 ,2005.06
-66132,0,0,0103100000,66132,6047,번식용,2005.06
-700550,0,0,0105111000,700550,3647,번식용,2005.06
-61184,0,0,0105191000,61184,559,오 리,2005.06
-28000,0,0,0106120000,28000,40,"고래ㆍ돌고래류(고래목의 포유동물), 바다소(바다소목의 포유동물) ",2005.06
8745,38843,3767,0106191000,30098,1098,개,2005.06
-10740,0,0,0106192000,10740,40,토끼,2005.06
-307958,9099,163,0106199000,317057,2582,기타,2005.06
-6233,2425,10,0106201000,8658,212,뱀,2005.06
-148734,0,0,0106202000,148734,21803,자라,2005.06
-5610,0,0,0106203000,5610,265,거북,2005.06
-11050,0,0,0106209000,11050,108,기타,2005.06
-4700,0,0,0106310000,4700,15,맹금류,2005.06
525,6525,61,0106390000,6000,38,기타,2005.06
4181,7224,208,0106901000,3043,34,양서류,2005.06
-25439,0,0,0106902090,25439,1943,기타 ,2005.06
-103840,24659,820,0106903010,128499,13208,갯지렁이,2005.06
-5965,0,0,0106903090,5965,3,기타,2005.06
-7345,0,0,0106909000,7345,274,기타,2005.06
-919092,0,0,0101101000,919092,25130,말(농가 사육용의 것에 한한다) ,2005.07
-530423,0,0,0101901010,530423,11540,경주말 ,2005.07
-440454,0,0,0101901090,440454,15150,기타 ,2005.07
-318178,0,0,0103100000,318178,30395,번식용,2005.07
-11000,0,0,0103920000,11000,700,중량이 50킬로그램 이상인 것,2005.07
-448310,0,0,0105111000,448310,3726,번식용,2005.07
-157861,0,0,0105191000,157861,1439,오 리,2005.07
-15580,0,0,0106110000,15580,29,영장류,2005.07
-35599,31488,3074,0106191000,67087,2200,개,2005.07
-253918,9924,183,0106199000,263842,2723,기타,2005.07
-35187,0,0,0106201000,35187,271,뱀,2005.07
-127150,0,0,0106202000,127150,19460,자라,2005.07
-45835,0,0,0106203000,45835,263,거북,2005.07
-10581,0,0,0106209000,10581,251,기타,2005.07
-24200,0,0,0106310000,24200,30,맹금류,2005.07
-8000,0,0,0106320000,8000,3,앵무류[패럿류(parrots)ㆍ패러키트류(parakeets)ㆍ금강앵무류ㆍ유황앵무류를 포함한다],2005.07
3657,3657,44,0106390000,0,0,기타,2005.07
4662,5094,115,0106901000,432,1,양서류,2005.07
-18380,0,0,0106902090,18380,1433,기타 ,2005.07
-188396,25960,787,0106903010,214356,23217,갯지렁이,2005.07
-8203,0,0,0106903090,8203,31,기타,2005.07
-4563,0,0,0106909000,4563,78,기타,2005.07
-285985,0,0,0101101000,285985,7560,말(농가 사육용의 것에 한한다) ,2005.08
-1132557,0,0,0101901010,1132557,24120,경주말 ,2005.08
-66831,0,0,0101901090,66831,2500,기타 ,2005.08
-105509,0,0,0103100000,105509,9628,번식용,2005.08
-320617,0,0,0105111000,320617,3440,번식용,2005.08
-154580,0,0,0105191000,154580,1516,오 리,2005.08
-85066,13648,1443,0106191000,98714,4052,개,2005.08
-279094,11671,202,0106199000,290765,3025,기타,2005.08
-4089,0,0,0106201000,4089,23,뱀,2005.08
-112136,0,0,0106202000,112136,17140,자라,2005.08
-24249,0,0,0106203000,24249,88,거북,2005.08
-2617,0,0,0106209000,2617,27,기타,2005.08
4284,4284,50,0106390000,0,0,기타,2005.08
-1452,0,0,0106901000,1452,13,양서류,2005.08
-30388,0,0,0106902090,30388,1945,기타 ,2005.08
-224390,22753,790,0106903010,247143,28014,갯지렁이,2005.08
-196,0,0,0106903090,196,3,기타,2005.08
-2389,0,0,0106909000,2389,113,기타,2005.08
-30922,0,0,0101101000,30922,500,말(농가 사육용의 것에 한한다) ,2005.09
-188318,0,0,0101901010,188318,1500,경주말 ,2005.09
-152717,0,0,0101901090,152717,500,기타 ,2005.09
-320093,307500,7175,0103100000,627593,43363,번식용,2005.09
-316050,0,0,0105111000,316050,600,번식용,2005.09
-102928,0,0,0105191000,102928,998,오 리,2005.09
-100040,0,0,0106110000,100040,438,영장류,2005.09
-14349,0,0,0106120000,14349,30,"고래ㆍ돌고래류(고래목의 포유동물), 바다소(바다소목의 포유동물) ",2005.09
-130482,15641,1918,0106191000,146123,3853,개,2005.09
-27,0,0,0106192000,27,1,토끼,2005.09
-30000,0,0,0106194000,30000,340,곰,2005.09
-281508,7509,167,0106199000,289017,2431,기타,2005.09
-583,0,0,0106201000,583,3,뱀,2005.09
-89480,0,0,0106202000,89480,14233,자라,2005.09
-26213,0,0,0106203000,26213,133,거북,2005.09
-8771,0,0,0106209000,8771,110,기타,2005.09
-556,0,0,0106901000,556,9,양서류,2005.09
-46025,0,0,0106902090,46025,3182,기타 ,2005.09
-182988,14198,448,0106903010,197186,22638,갯지렁이,2005.09
-5894,0,0,0106903090,5894,3,기타,2005.09
-3594,0,0,0106909000,3594,368,기타,2005.09
-42000,0,0,0101101000,42000,500,말(농가 사육용의 것에 한한다) ,2005.10
-2273754,0,0,0101901010,2273754,50350,경주말 ,2005.10
-58301,0,0,0101901090,58301,2500,기타 ,2005.10
72839,351722,15000,0103100000,278883,18535,번식용,2005.10
-16182,0,0,0103920000,16182,980,중량이 50킬로그램 이상인 것,2005.10
-21612,0,0,0105111000,21612,171,번식용,2005.10
-207577,0,0,0105191000,207577,2035,오 리,2005.10
-47782,20842,2552,0106191000,68624,1880,개,2005.10
-265906,16091,322,0106199000,281997,2334,기타,2005.10
-8013,0,0,0106201000,8013,27,뱀,2005.10
-73703,0,0,0106202000,73703,11572,자라,2005.10
-57514,0,0,0106203000,57514,618,거북,2005.10
-1602,0,0,0106209000,1602,17,기타,2005.10
2158,3104,33,0106390000,946,8,기타,2005.10
-1262,0,0,0106901000,1262,25,양서류,2005.10
-15241,0,0,0106902090,15241,796,기타 ,2005.10
-186599,15423,412,0106903010,202022,24229,갯지렁이,2005.10
-8265,0,0,0106903090,8265,31,기타,2005.10
-7860,0,0,0106909000,7860,472,기타,2005.10
-218879,0,0,0101101000,218879,3940,말(농가 사육용의 것에 한한다) ,2005.11
-210884,0,0,0101901010,210884,5130,경주말 ,2005.11
-235012,0,0,0101901090,235012,6000,기타 ,2005.11
746,746,98,0102902000,0,0,육우 ,2005.11
-84026,0,0,0103100000,84026,4132,번식용,2005.11
-18245,0,0,0103910000,18245,129,중량이 50킬로그램 미만인 것,2005.11
-36000,0,0,0105111000,36000,403,번식용,2005.11
35000,35000,150,0106120000,0,0,"고래ㆍ돌고래류(고래목의 포유동물), 바다소(바다소목의 포유동물) ",2005.11
-61578,16567,2368,0106191000,78145,2460,개,2005.11
-333244,31749,368,0106199000,364993,3381,기타,2005.11
-1579,0,0,0106201000,1579,4,뱀,2005.11
-48601,0,0,0106202000,48601,7311,자라,2005.11
-13191,0,0,0106203000,13191,228,거북,2005.11
-11362,0,0,0106209000,11362,204,기타,2005.11
680,680,2,0106390000,0,0,기타,2005.11
-3730,0,0,0106901000,3730,31,양서류,2005.11
-34609,0,0,0106902090,34609,2256,기타 ,2005.11
-41245,44397,1024,0106903010,85642,9530,갯지렁이,2005.11
2694,2694,500,0106903020,0,0,실지렁이,2005.11
-5694,0,0,0106903090,5694,3,기타,2005.11
-6089,0,0,0106909000,6089,282,기타,2005.11
-1734766,0,0,0101101000,1734766,28395,말(농가 사육용의 것에 한한다) ,2005.12
-153649,588483,500,0101901010,742132,17200,경주말 ,2005.12
-490060,0,0,0101901090,490060,17100,기타 ,2005.12
-7940,0,0,0101909000,7940,5000,기타 ,2005.12
-259010,105000,2500,0103100000,364010,32276,번식용,2005.12
-35000,0,0,0103910000,35000,2500,중량이 50킬로그램 미만인 것,2005.12
-1438316,0,0,0105111000,1438316,7902,번식용,2005.12
-182294,0,0,0105191000,182294,1683,오 리,2005.12
-336267,0,0,0106110000,336267,313,영장류,2005.12
-138267,22223,3044,0106191000,160490,3543,개,2005.12
28206,28206,1100,0106194000,0,0,곰,2005.12
-287963,10118,306,0106199000,298081,3032,기타,2005.12
-5359,0,0,0106201000,5359,38,뱀,2005.12
-80419,0,0,0106202000,80419,12174,자라,2005.12
-3246,0,0,0106203000,3246,382,거북,2005.12
-12051,0,0,0106209000,12051,539,기타,2005.12
938,938,12,0106390000,0,0,기타,2005.12
-1515,0,0,0106901000,1515,12,양서류,2005.12
-41063,0,0,0106902090,41063,3228,기타 ,2005.12
-42463,2468,95,0106903010,44931,4632,갯지렁이,2005.12
-5719,0,0,0106903090,5719,3,기타,2005.12
-6052,0,0,0106909000,6052,37,기타,2005.12
-35440084,3400489,79121,-,38840573,1481540,-,총계
-267862,0,0,0101101000,267862,3700,말(농가 사육용의 것에 한한다) ,2006.01
-552221,0,0,0101901010,552221,15800,경주말 ,2006.01
-4810823,0,0,0101901090,4810823,10500,기타 ,2006.01
-1193108,0,0,0102902000,1193108,412250,육우 ,2006.01
-660319,0,0,0103100000,660319,25325,번식용,2006.01
-168000,0,0,0105111000,168000,1189,번식용,2006.01
-244326,0,0,0105191000,244326,2374,오 리,2006.01
-96719,36321,3530,0106191000,133040,4256,개,2006.01
23855,23855,2100,0106193000,0,0,사슴,2006.01
-245257,18586,227,0106199000,263843,2336,기타,2006.01
-5180,0,0,0106201000,5180,44,뱀,2006.01
-52647,0,0,0106202000,52647,8268,자라,2006.01
-14932,0,0,0106203000,14932,413,거북,2006.01
-2651,0,0,0106209000,2651,10,기타,2006.01
530,890,14,0106390000,360,5,기타,2006.01
-6537,0,0,0106901000,6537,80,양서류,2006.01
-23338,0,0,0106902090,23338,2298,기타 ,2006.01
-53000,4124,164,0106903010,57124,5798,갯지렁이,2006.01
-2500,0,0,0106903090,2500,30,기타,2006.01
-3710,0,0,0106909000,3710,132,기타,2006.01
-441124,19056,1137,0101101000,460180,5950,말(농가 사육용의 것에 한한다) ,2006.02
-671790,0,0,0101901010,671790,15440,경주말 ,2006.02
-86102,0,0,0101901090,86102,10600,기타 ,2006.02
-67772,0,0,0103100000,67772,4690,번식용,2006.02
-22324,0,0,0105191000,22324,243,오 리,2006.02
-69798,27968,3696,0106191000,97766,3030,개,2006.02
-254165,10672,196,0106199000,264837,2461,기타,2006.02
-130,0,0,0106201000,130,1,뱀,2006.02
-67697,0,0,0106202000,67697,10560,자라,2006.02
-12341,0,0,0106203000,12341,619,거북,2006.02
-3466,0,0,0106209000,3466,6,기타,2006.02
1454,1454,19,0106390000,0,0,기타,2006.02
-1211,0,0,0106901000,1211,37,양서류,2006.02
-39980,0,0,0106902090,39980,3322,기타 ,2006.02
-48906,4879,187,0106903010,53785,4996,갯지렁이,2006.02
-5854,0,0,0106903090,5854,3,기타,2006.02
-5694,0,0,0106909000,5694,309,기타,2006.02
-34000,0,0,0101101000,34000,800,말(농가 사육용의 것에 한한다) ,2006.03
-474021,0,0,0101901010,474021,12780,경주말 ,2006.03
-90078,0,0,0101901090,90078,31968,기타 ,2006.03
-68961,0,0,0103100000,68961,4401,번식용,2006.03
-29862,0,0,0105191000,29862,285,오 리,2006.03
-51277,34895,4631,0106191000,86172,2824,개,2006.03
-355095,13159,257,0106199000,368254,3106,기타,2006.03
-5689,0,0,0106201000,5689,18,뱀,2006.03
-98850,0,0,0106202000,98850,12875,자라,2006.03
-27006,0,0,0106203000,27006,645,거북,2006.03
-3768,0,0,0106209000,3768,26,기타,2006.03
3013,3013,44,0106390000,0,0,기타,2006.03
-9227,0,0,0106901000,9227,164,양서류,2006.03
-54995,0,0,0106902090,54995,3845,기타 ,2006.03
-81847,6954,265,0106903010,88801,8388,갯지렁이,2006.03
-8244,0,0,0106903090,8244,33,기타,2006.03
-5518,0,0,0106909000,5518,554,기타,2006.03
-55261,0,0,0101101000,55261,2570,말(농가 사육용의 것에 한한다) ,2006.04
-123128,0,0,0101901010,123128,3030,경주말 ,2006.04
-42145,0,0,0101901090,42145,1100,기타 ,2006.04
-1165957,0,0,0102902000,1165957,373170,육우 ,2006.04
-283439,0,0,0103100000,283439,17560,번식용,2006.04
-296405,0,0,0105191000,296405,2614,오 리,2006.04
-64850,0,0,0106110000,64850,250,영장류,2006.04
-86492,46812,6116,0106191000,133304,2943,개,2006.04
-312729,13812,223,0106199000,326541,2771,기타,2006.04
-6559,0,0,0106201000,6559,28,뱀,2006.04
-80899,0,0,0106202000,80899,9551,자라,2006.04
-5644,0,0,0106203000,5644,493,거북,2006.04
-54472,0,0,0106209000,54472,463,기타,2006.04
22269,22269,66,0106390000,0,0,기타,2006.04
18143,18183,410,0106901000,40,10,양서류,2006.04
-47205,0,0,0106902090,47205,3754,기타 ,2006.04
-143098,10113,381,0106903010,153211,16590,갯지렁이,2006.04
2017,2017,370,0106903020,0,0,실지렁이,2006.04
-5969,0,0,0106903090,5969,6,기타,2006.04
-2453,0,0,0106909000,2453,237,기타,2006.04
91792,91792,2000,0101101000,0,0,말(농가 사육용의 것에 한한다) ,2006.05
-779961,0,0,0101901010,779961,14840,경주말 ,2006.05
-29927,0,0,0101901090,29927,1000,기타 ,2006.05
-447130,0,0,0103100000,447130,29126,번식용,2006.05
-219383,0,0,0104201000,219383,18460,젖염소,2006.05
-154440,0,0,0105111000,154440,1189,번식용,2006.05
-98000,0,0,0105191000,98000,794,오 리,2006.05
-10200,0,0,0106110000,10200,40,영장류,2006.05
-153240,4834,616,0106191000,158074,5107,개,2006.05
-366305,20285,404,0106199000,386590,3272,기타,2006.05
-2170,0,0,0106201000,2170,6,뱀,2006.05
-127259,0,0,0106202000,127259,13243,자라,2006.05
-22599,0,0,0106203000,22599,341,거북,2006.05
-16346,0,0,0106209000,16346,43,기타,2006.05
-689,5561,56,0106390000,6250,18,기타,2006.05
-1822,7684,210,0106901000,9506,59,양서류,2006.05
-38898,0,0,0106902090,38898,3535,기타 ,2006.05
-178336,15809,580,0106903010,194145,20475,갯지렁이,2006.05
-3832,0,0,0106909000,3832,269,기타,2006.05
-230369,0,0,0101101000,230369,3500,말(농가 사육용의 것에 한한다) ,2006.06
-448413,0,0,0101901010,448413,10800,경주말 ,2006.06
-320852,0,0,0101901090,320852,4300,기타 ,2006.06
-326016,387,4,0102101000,326403,1000,젖소 ,2006.06
-236772,0,0,0103100000,236772,14450,번식용,2006.06
-58669,0,0,0103920000,58669,2660,중량이 50킬로그램 이상인 것,2006.06
-312575,0,0,0104201000,312575,29000,젖염소,2006.06
-412152,0,0,0105111000,412152,2302,번식용,2006.06
-194357,0,0,0105191000,194357,1817,오 리,2006.06
-108874,31766,4114,0106191000,140640,3912,개,2006.06
-69,0,0,0106192000,69,2,토끼,2006.06
-396169,8185,142,0106199000,404354,3794,기타,2006.06
-12567,0,0,0106201000,12567,319,뱀,2006.06
-121028,0,0,0106202000,121028,13276,자라,2006.06
-13164,0,0,0106203000,13164,275,거북,2006.06
-12005,0,0,0106209000,12005,206,기타,2006.06
2415,7026,249,0106901000,4611,114,양서류,2006.06
-41633,0,0,0106902090,41633,3958,기타 ,2006.06
-195703,12759,436,0106903010,208462,19848,갯지렁이,2006.06
-14747,0,0,0106903090,14747,34,기타,2006.06
-2319,0,0,0106909000,2319,161,기타,2006.06
-1788406,17600,1450,0101101000,1806006,27300,말(농가 사육용의 것에 한한다) ,2006.07
-315173,0,0,0101901010,315173,7300,경주말 ,2006.07
-59685,0,0,0101901090,59685,14700,기타 ,2006.07
-1075599,0,0,0103100000,1075599,61273,번식용,2006.07
-1125693,0,0,0105111000,1125693,4900,번식용,2006.07
-173640,0,0,0105191000,173640,1449,오 리,2006.07
-116846,21566,2805,0106191000,138412,4183,개,2006.07
-23,0,0,0106192000,23,3,토끼,2006.07
2982,2982,145,0106193000,0,0,사슴,2006.07
-285091,14099,240,0106199000,299190,2763,기타,2006.07
-14530,0,0,0106201000,14530,89,뱀,2006.07
-137313,0,0,0106202000,137313,15527,자라,2006.07
-40019,0,0,0106203000,40019,532,거북,2006.07
-18200,0,0,0106209000,18200,1092,기타,2006.07
1488,1488,17,0106390000,0,0,기타,2006.07
-3773,1828,35,0106901000,5601,144,양서류,2006.07
-11596,0,0,0106902090,11596,1031,기타 ,2006.07
-222801,16354,486,0106903010,239155,22312,갯지렁이,2006.07
-12068,0,0,0106903090,12068,6,기타,2006.07
-7573,0,0,0106909000,7573,1029,기타,2006.07
-85000,0,0,0101901010,85000,2200,경주말 ,2006.08
-386572,0,0,0101901090,386572,12200,기타 ,2006.08
-37800,0,0,0103100000,37800,3768,번식용,2006.08
-458970,0,0,0104201000,458970,31500,젖염소,2006.08
-171500,0,0,0105111000,171500,1550,번식용,2006.08
96708,96708,885,0105119000,0,0,기타,2006.08
-215279,0,0,0105191000,215279,1885,오 리,2006.08
-249571,7288,1185,0106191000,256859,7076,개,2006.08
-10,0,0,0106192000,10,1,토끼,2006.08
-420565,8950,192,0106199000,429515,3397,기타,2006.08
-3770,0,0,0106201000,3770,31,뱀,2006.08
-123987,0,0,0106202000,123987,12854,자라,2006.08
-39936,0,0,0106203000,39936,342,거북,2006.08
-9690,0,0,0106209000,9690,118,기타,2006.08
-3609,0,0,0106901000,3609,42,양서류,2006.08
-24262,0,0,0106902090,24262,1984,기타 ,2006.08
-301474,14817,470,0106903010,316291,29982,갯지렁이,2006.08
-8734,0,0,0106903090,8734,29,기타,2006.08
-2569,0,0,0106909000,2569,140,기타,2006.08
-716903,0,0,0101101000,716903,8803,말(농가 사육용의 것에 한한다) ,2006.09
-462988,0,0,0101901010,462988,12060,경주말 ,2006.09
-119089,0,0,0101901090,119089,6878,기타 ,2006.09
-440466,0,0,0102101000,440466,2200,젖소 ,2006.09
-258789,0,0,0103100000,258789,12560,번식용,2006.09
-67762,0,0,0105111000,67762,410,번식용,2006.09
-179933,0,0,0105191000,179933,1526,오 리,2006.09
-176133,17273,2255,0106191000,193406,4102,개,2006.09
-357614,17713,384,0106199000,375327,2968,기타,2006.09
-10299,0,0,0106201000,10299,30,뱀,2006.09
-146366,0,0,0106202000,146366,13681,자라,2006.09
-47935,0,0,0106203000,47935,657,거북,2006.09
-18503,0,0,0106209000,18503,126,기타,2006.09
2089,2140,17,0106390000,51,10,기타,2006.09
-6501,0,0,0106901000,6501,215,양서류,2006.09
-59882,0,0,0106902090,59882,2426,기타 ,2006.09
-308800,17857,407,0106903010,326657,32421,갯지렁이,2006.09
-7940,0,0,0106909000,7940,1174,기타,2006.09
-91229,2286,29,0101101000,93515,3000,말(농가 사육용의 것에 한한다) ,2006.10
-71244,0,0,0101901010,71244,2000,경주말 ,2006.10
-929520,0,0,0101901090,929520,20315,기타 ,2006.10
-555817,0,0,0102101000,555817,2100,젖소 ,2006.10
-174500,0,0,0103100000,174500,12920,번식용,2006.10
-346150,0,0,0105111000,346150,600,번식용,2006.10
-181080,0,0,0105191000,181080,1692,오 리,2006.10
-79000,0,0,0106110000,79000,40,영장류,2006.10
-164791,0,0,0106191000,164791,3657,개,2006.10
-325385,17205,320,0106199000,342590,2726,기타,2006.10
-6761,0,0,0106201000,6761,22,뱀,2006.10
-85488,0,0,0106202000,85488,7936,자라,2006.10
-33007,0,0,0106203000,33007,1831,거북,2006.10
-4440,0,0,0106209000,4440,38,기타,2006.10
-48350,0,0,0106390000,48350,230,기타,2006.10
-1119,0,0,0106901000,1119,68,양서류,2006.10
-61987,0,0,0106902090,61987,1453,기타 ,2006.10
-336066,16283,423,0106903010,352349,34114,갯지렁이,2006.10
-8704,0,0,0106903090,8704,26,기타,2006.10
-9246,0,0,0106909000,9246,1460,기타,2006.10
-3335053,0,0,0101101000,3335053,4381,말(농가 사육용의 것에 한한다) ,2006.11
-1036405,0,0,0101901010,1036405,10430,경주말 ,2006.11
-125255,0,0,0101901090,125255,6300,기타 ,2006.11
-1214621,0,0,0102902000,1214621,306075,육우 ,2006.11
-528381,0,0,0103100000,528381,45156,번식용,2006.11
-464589,0,0,0105111000,464589,7294,번식용,2006.11
-100898,0,0,0105119000,100898,2444,기타,2006.11
-196863,0,0,0105191000,196863,1552,오 리,2006.11
-8000,0,0,0106110000,8000,3,영장류,2006.11
-142265,0,0,0106191000,142265,2295,개,2006.11
-30000,0,0,0106194000,30000,300,곰,2006.11
-386989,13304,237,0106199000,400293,3359,기타,2006.11
-4352,0,0,0106201000,4352,8,뱀,2006.11
-113324,0,0,0106202000,113324,10037,자라,2006.11
-32014,0,0,0106203000,32014,1802,거북,2006.11
-15852,0,0,0106209000,15852,161,기타,2006.11
-42000,0,0,0106320000,42000,20,앵무류[패럿류(parrots)ㆍ패러키트류(parakeets)ㆍ금강앵무류ㆍ유황앵무류를 포함한다],2006.11
-61,417,7,0106390000,478,5,기타,2006.11
-7999,0,0,0106901000,7999,145,양서류,2006.11
-49877,0,0,0106902090,49877,2282,기타 ,2006.11
-91448,15479,455,0106903010,106927,10153,갯지렁이,2006.11
2419,2419,435,0106903020,0,0,실지렁이,2006.11
-6284,0,0,0106903090,6284,1,기타,2006.11
-15263,0,0,0106909000,15263,784,기타,2006.11
-5040477,0,0,0101101000,5040477,54263,말(농가 사육용의 것에 한한다) ,2006.12
-1779929,0,0,0101901010,1779929,13487,경주말 ,2006.12
-395528,0,0,0101901090,395528,8865,기타 ,2006.12
-434445,0,0,0103100000,434445,24075,번식용,2006.12
-2214300,0,0,0105111000,2214300,12387,번식용,2006.12
-107906,0,0,0105191000,107906,848,오 리,2006.12
-25080,0,0,0106110000,25080,80,영장류,2006.12
-90629,5358,376,0106191000,95987,1339,개,2006.12
-98,0,0,0106192000,98,3,토끼,2006.12
-279149,13499,227,0106199000,292648,2401,기타,2006.12
-3116,0,0,0106201000,3116,16,뱀,2006.12
-57135,0,0,0106202000,57135,5081,자라,2006.12
-16315,0,0,0106203000,16315,1606,거북,2006.12
-2664,0,0,0106209000,2664,12,기타,2006.12
-992,0,0,0106390000,992,5,기타,2006.12
-11478,0,0,0106901000,11478,91,양서류,2006.12
-170348,0,0,0106902090,170348,3225,기타 ,2006.12
-79297,5935,210,0106903010,85232,7899,갯지렁이,2006.12
-8931,0,0,0106903090,8931,27,기타,2006.12
-358,0,0,0106909000,358,65,기타,2006.12
-53731525,875968,46532,-,54607493,2328441,-,총계
-1282596,0,0,0101101000,1282596,25150,말(농가 사육용의 것에 한한다) ,2007.01
-415805,0,0,0101901010,415805,8625,경주말 ,2007.01
-93148,0,0,0101901090,93148,2925,기타 ,2007.01
-290956,0,0,0103100000,290956,24750,번식용,2007.01
-81551,0,0,0105191010,81551,595,번식용의 것 ,2007.01
-77126,12018,712,0106191000,89144,1428,개,2007.01
16,16,8,0106192090,0,0,기타 ,2007.01
-323049,17441,335,0106199000,340490,2467,기타,2007.01
-7665,0,0,0106201000,7665,297,뱀,2007.01
-64199,0,0,0106202000,64199,5562,자라,2007.01
-22901,3062,3,0106203000,25963,4141,거북,2007.01
-55005,0,0,0106209000,55005,3987,기타,2007.01
-3290,0,0,0106901000,3290,18,양서류,2007.01
-164038,0,0,0106902090,164038,3135,기타 ,2007.01
-90566,4123,147,0106903010,94689,8685,갯지렁이,2007.01
-6568,0,0,0106903090,6568,9,기타,2007.01
-1865,0,0,0106909000,1865,353,기타,2007.01
-515267,0,0,0101101000,515267,9249,말(농가 사육용의 것에 한한다) ,2007.02
-944631,0,0,0101901010,944631,18600,경주말 ,2007.02
-65303,0,0,0101901090,65303,900,기타 ,2007.02
-14263,0,0,0101909000,14263,4900,기타 ,2007.02
-60196,0,0,0105191010,60196,482,번식용의 것 ,2007.02
-54021,17541,680,0106191000,71562,1032,개,2007.02
-99,0,0,0106192090,99,0,기타 ,2007.02
-3194,0,0,0106195090,3194,58,기타,2007.02
-310393,14267,230,0106199000,324660,2968,기타,2007.02
-8439,0,0,0106201000,8439,33,뱀,2007.02
-74668,0,0,0106202000,74668,6696,자라,2007.02
-36055,0,0,0106203000,36055,5372,거북,2007.02
-26668,0,0,0106209000,26668,323,기타,2007.02
-3183,0,0,0106901000,3183,14,양서류,2007.02
-58007,0,0,0106902090,58007,2124,기타 ,2007.02
-103149,5100,181,0106903010,108249,9514,갯지렁이,2007.02
-6510,0,0,0106903090,6510,1,기타,2007.02
-3288,0,0,0106909000,3288,421,기타,2007.02
-241685,0,0,0101101000,241685,4015,말(농가 사육용의 것에 한한다) ,2007.03
-471002,0,0,0101901010,471002,8610,경주말 ,2007.03
-58200,0,0,0101901090,58200,3445,기타 ,2007.03
-77250,0,0,0103100000,77250,4586,번식용,2007.03
-61809,0,0,0105191010,61809,614,번식용의 것 ,2007.03
-114202,24613,411,0106191000,138815,2129,개,2007.03
-25,0,0,0106192090,25,2,기타 ,2007.03
-327212,14991,354,0106199000,342203,3090,기타,2007.03
-3062,0,0,0106201000,3062,16,뱀,2007.03
-71512,0,0,0106202000,71512,6172,자라,2007.03
-46908,0,0,0106203000,46908,1796,거북,2007.03
-21420,0,0,0106209000,21420,400,기타,2007.03
-1136,0,0,0106390000,1136,9,기타,2007.03
-9788,0,0,0106901000,9788,166,양서류,2007.03
-78596,0,0,0106902090,78596,4828,기타 ,2007.03
-156440,5905,210,0106903010,162345,14540,갯지렁이,2007.03
-9883,0,0,0106903090,9883,681,기타,2007.03
-2852,0,0,0106909000,2852,62,기타,2007.03
4882,4882,90,0101101000,0,0,말(농가 사육용의 것에 한한다) ,2007.04
-491621,0,0,0101901010,491621,7990,경주말 ,2007.04
-214851,0,0,0101901090,214851,18700,기타 ,2007.04
-526499,0,0,0103100000,526499,21096,번식용,2007.04
-297000,0,0,0105111000,297000,2476,번식용,2007.04
-111538,0,0,0105191010,111538,1054,번식용의 것 ,2007.04
-90700,34572,527,0106191000,125272,1800,개,2007.04
-10750,0,0,0106192090,10750,70,기타 ,2007.04
-446355,22767,577,0106199000,469122,5438,기타,2007.04
-14022,0,0,0106201000,14022,56,뱀,2007.04
-138636,0,0,0106202000,138636,12675,자라,2007.04
-15931,0,0,0106203000,15931,778,거북,2007.04
-8149,0,0,0106209000,8149,34,기타,2007.04
-20800,0,0,0106390000,20800,80,기타,2007.04
7818,10935,260,0106901000,3117,57,양서류,2007.04
-97457,0,0,0106902090,97457,4021,기타 ,2007.04
-59831,8047,285,0106903010,67878,6070,갯지렁이,2007.04
-13085,0,0,0106903090,13085,2,기타,2007.04
-300,0,0,0106909000,300,60,기타,2007.04
-376071,0,0,0101901010,376071,6180,경주말 ,2007.05
-313269,0,0,0101901090,313269,6500,기타 ,2007.05
-61925,0,0,0103100000,61925,4607,번식용,2007.05
-465671,0,0,0105111000,465671,4644,번식용,2007.05
-296992,0,0,0105191010,296992,2875,번식용의 것 ,2007.05
-11940,0,0,0106110000,11940,22,영장류,2007.05
-144631,33105,590,0106191000,177736,2404,개,2007.05
-390639,18960,434,0106199000,409599,4693,기타,2007.05
-10729,0,0,0106201000,10729,51,뱀,2007.05
-126095,0,0,0106202000,126095,9109,자라,2007.05
-14903,0,0,0106203000,14903,368,거북,2007.05
-37446,0,0,0106209000,37446,438,기타,2007.05
-12112,4390,81,0106901000,16502,302,양서류,2007.05
-84983,0,0,0106902090,84983,3368,기타 ,2007.05
-71897,10904,386,0106903010,82801,7254,갯지렁이,2007.05
-2700,0,0,0106903090,2700,10,기타,2007.05
-2117,0,0,0106909000,2117,473,기타,2007.05
-8078,0,0,0101109000,8078,1200,기타 ,2007.06
-526658,0,0,0101901010,526658,9030,경주말 ,2007.06
-797443,0,0,0101901090,797443,14850,기타 ,2007.06
-27708,0,0,0101909000,27708,1500,기타 ,2007.06
-581573,0,0,0102101000,581573,2600,젖소 ,2007.06
-569421,0,0,0103100000,569421,50066,번식용,2007.06
-947686,0,0,0105111000,947686,4278,번식용,2007.06
-376705,0,0,0105191010,376705,2839,번식용의 것 ,2007.06
-375145,0,0,0106110000,375145,292,영장류,2007.06
-231190,42351,929,0106191000,273541,3966,개,2007.06
-334359,11016,328,0106199000,345375,3535,기타,2007.06
-9293,0,0,0106201000,9293,31,뱀,2007.06
-159721,0,0,0106202000,159721,12586,자라,2007.06
-20331,0,0,0106203000,20331,431,거북,2007.06
-38776,0,0,0106209000,38776,779,기타,2007.06
16,16,15,0106320000,0,0,앵무류[패럿류(parrots)ㆍ패러키트류(parakeets)ㆍ금강앵무류ㆍ유황앵무류를 포함한다],2007.06
-646,0,0,0106390000,646,10,기타,2007.06
-4014,2388,85,0106901000,6402,76,양서류,2007.06
-72185,0,0,0106902090,72185,2859,기타 ,2007.06
-124515,5772,204,0106903010,130287,12934,갯지렁이,2007.06
-6538,0,0,0106903090,6538,1,기타,2007.06
-650,0,0,0106909000,650,130,기타,2007.06
-1314300,0,0,0101101000,1314300,19800,말(농가 사육용의 것에 한한다) ,2007.07
-2424170,0,0,0101901010,2424170,16417,경주말 ,2007.07
-135087,0,0,0101901090,135087,8283,기타 ,2007.07
-12182,0,0,0101909000,12182,500,기타 ,2007.07
-224864,0,0,0102101000,224864,1700,젖소 ,2007.07
-214538,0,0,0103100000,214538,7871,번식용,2007.07
-329116,0,0,0105111000,329116,4235,번식용,2007.07
-188203,0,0,0105191010,188203,1556,번식용의 것 ,2007.07
-116801,54797,888,0106191000,171598,2087,개,2007.07
-84,16,3,0106192090,100,10,기타 ,2007.07
-429378,11679,260,0106199000,441057,4000,기타,2007.07
-39473,0,0,0106201000,39473,1245,뱀,2007.07
-135547,0,0,0106202000,135547,9340,자라,2007.07
-70123,0,0,0106203000,70123,763,거북,2007.07
-24773,0,0,0106209000,24773,685,기타,2007.07
-400,0,0,0106390000,400,18,기타,2007.07
-5499,0,0,0106901000,5499,53,양서류,2007.07
-48137,0,0,0106902090,48137,1307,기타 ,2007.07
-130638,6006,213,0106903010,136644,12487,갯지렁이,2007.07
-9346,0,0,0106903090,9346,11,기타,2007.07
-150,0,0,0106909000,150,2,기타,2007.07
-13548,0,0,0101101000,13548,500,말(농가 사육용의 것에 한한다) ,2007.08
-886074,0,0,0101901010,886074,22000,경주말 ,2007.08
-266167,0,0,0101901090,266167,4650,기타 ,2007.08
-226470,0,0,0103100000,226470,14207,번식용,2007.08
-413084,0,0,0105111000,413084,1927,번식용,2007.08
-100367,0,0,0105191010,100367,768,번식용의 것 ,2007.08
-23041,0,0,0106110000,23041,33,영장류,2007.08
-156231,50464,761,0106191000,206695,2309,개,2007.08
16,16,10,0106192090,0,0,기타 ,2007.08
-407845,11438,274,0106199000,419283,4159,기타,2007.08
-7680,0,0,0106201000,7680,27,뱀,2007.08
-225885,0,0,0106202000,225885,15698,자라,2007.08
-47926,0,0,0106203000,47926,391,거북,2007.08
-17183,0,0,0106209000,17183,91,기타,2007.08
-60,0,0,0106901000,60,1,양서류,2007.08
-48285,0,0,0106902090,48285,1066,기타 ,2007.08
-360676,9178,279,0106903010,369854,41397,갯지렁이,2007.08
-6785,0,0,0106903090,6785,1,기타,2007.08
-1501,0,0,0106909000,1501,90,기타,2007.08
-473268,0,0,0101901010,473268,2500,경주말 ,2007.09
-742276,0,0,0101901090,742276,10680,기타 ,2007.09
-245811,0,0,0103100000,245811,14890,번식용,2007.09
-643064,37500,646,0105111000,680564,5913,번식용,2007.09
-319098,0,0,0105191010,319098,2308,번식용의 것 ,2007.09
-14720,0,0,0106110000,14720,41,영장류,2007.09
-221070,25708,603,0106191000,246778,2892,개,2007.09
-74,0,0,0106192090,74,3,기타 ,2007.09
-1680,0,0,0106195090,1680,10,기타,2007.09
-373803,12431,279,0106199000,386234,4024,기타,2007.09
-11876,0,0,0106201000,11876,17,뱀,2007.09
-88760,0,0,0106202000,88760,6128,자라,2007.09
-18055,0,0,0106203000,18055,429,거북,2007.09
-11746,0,0,0106209000,11746,43,기타,2007.09
-1450,0,0,0106390000,1450,8,기타,2007.09
-3136,0,0,0106901000,3136,16,양서류,2007.09
-65461,5111,40,0106902090,70572,1067,기타 ,2007.09
-259695,11332,240,0106903010,271027,31922,갯지렁이,2007.09
-9421,0,0,0106903090,9421,81,기타,2007.09
-15129,0,0,0106909000,15129,535,기타,2007.09
-29243,0,0,0101101000,29243,1500,말(농가 사육용의 것에 한한다) ,2007.10
-52533,0,0,0101109000,52533,1500,기타 ,2007.10
-338106,0,0,0101901010,338106,10680,경주말 ,2007.10
-5501842,0,0,0101901090,5501842,8650,기타 ,2007.10
-586296,0,0,0103100000,586296,32140,번식용,2007.10
-12305,0,0,0103910000,12305,40,중량이 50킬로그램 미만인 것,2007.10
-87626,155519,2693,0105111000,243145,600,번식용,2007.10
-220908,0,0,0105191010,220908,1533,번식용의 것 ,2007.10
-437425,0,0,0106110000,437425,314,영장류,2007.10
-194611,57906,684,0106191000,252517,2918,개,2007.10
-121,0,0,0106192090,121,5,기타 ,2007.10
-40979,0,0,0106194000,40979,362,곰,2007.10
-375371,23735,427,0106199000,399106,3522,기타,2007.10
-13672,0,0,0106201000,13672,54,뱀,2007.10
-137010,0,0,0106202000,137010,11654,자라,2007.10
-36759,0,0,0106203000,36759,564,거북,2007.10
-4676,0,0,0106209000,4676,25,기타,2007.10
-6093,0,0,0106901000,6093,119,양서류,2007.10
-18433,110588,448,0106902090,129021,1722,기타 ,2007.10
-212081,17625,333,0106903010,229706,24598,갯지렁이,2007.10
-9435,0,0,0106903090,9435,11,기타,2007.10
-86680,0,0,0106909000,86680,951,기타,2007.10
-439871,594,110,0101101000,440465,8860,말(농가 사육용의 것에 한한다) ,2007.11
-18319,0,0,0101109000,18319,1200,기타 ,2007.11
-183140,0,0,0101901010,183140,8500,경주말 ,2007.11
-121178,0,0,0101901090,121178,2960,기타 ,2007.11
-921693,28000,200,0103100000,949693,83361,번식용,2007.11
-54369,0,0,0103910000,54369,617,중량이 50킬로그램 미만인 것,2007.11
-308776,0,0,0103920000,308776,39720,중량이 50킬로그램 이상인 것,2007.11
1000,1000,550,0104209000,0,0,기타,2007.11
-287310,35250,592,0105111000,322560,2482,번식용,2007.11
-282542,0,0,0105191010,282542,2027,번식용의 것 ,2007.11
-540000,0,0,0106110000,540000,80,영장류,2007.11
-119550,56129,744,0106191000,175679,1988,개,2007.11
16,16,10,0106192090,0,0,기타 ,2007.11
-128496,25292,248,0106199000,153788,1190,기타,2007.11
-6666,0,0,0106201000,6666,30,뱀,2007.11
-140351,0,0,0106202000,140351,11507,자라,2007.11
-20958,0,0,0106203000,20958,621,거북,2007.11
-14739,0,0,0106209000,14739,134,기타,2007.11
-1422,0,0,0106310000,1422,27,맹금류,2007.11
-2290,8,8,0106390000,2298,40,기타,2007.11
-1098,0,0,0106901000,1098,6,양서류,2007.11
-121631,0,0,0106902090,121631,1996,기타 ,2007.11
-103915,15064,356,0106903010,118979,11462,갯지렁이,2007.11
-6756,0,0,0106903090,6756,1,기타,2007.11
-252565,0,0,0106909000,252565,2650,기타,2007.11
-3411215,0,0,0101101000,3411215,52380,말(농가 사육용의 것에 한한다) ,2007.12
-1745151,0,0,0101901010,1745151,38800,경주말 ,2007.12
-441967,0,0,0101901090,441967,12565,기타 ,2007.12
-766727,0,0,0102101000,766727,3448,젖소 ,2007.12
-245055,42000,650,0103100000,287055,13736,번식용,2007.12
-1000304,0,0,0105111000,1000304,4125,번식용,2007.12
-174046,0,0,0106110000,174046,248,영장류,2007.12
-120909,65281,795,0106191000,186190,2084,개,2007.12
-62916,34030,2185,0106199000,96946,698,기타,2007.12
-11348,0,0,0106201000,11348,66,뱀,2007.12
-98720,0,0,0106202000,98720,8003,자라,2007.12
-23509,0,0,0106203000,23509,410,거북,2007.12
-13704,0,0,0106209000,13704,124,기타,2007.12
-789,0,0,0106310000,789,11,맹금류,2007.12
-19806,0,0,0106320000,19806,10,앵무류[패럿류(parrots)ㆍ패러키트류(parakeets)ㆍ금강앵무류ㆍ유황앵무류를 포함한다],2007.12
-3482,0,0,0106901000,3482,51,양서류,2007.12
-187416,0,0,0106902090,187416,2914,기타 ,2007.12
-70461,1142,41,0106903010,71603,6276,갯지렁이,2007.12
-9525,0,0,0106903090,9525,11,기타,2007.12
-193961,0,0,0106909000,193961,1710,기타,2007.12
-50863221,1234037,23628,-,52097258,1187506,-,총계
-487914,0,0,0101101000,487914,6500,말(농가 사육용의 것에 한한다) ,2008.01
-499484,0,0,0101901010,499484,8500,경주말 ,2008.01
-67420,0,0,0101901090,67420,1800,기타 ,2008.01
-160824,0,0,0103100000,160824,8130,번식용,2008.01
-852291,0,0,0105111000,852291,3600,번식용,2008.01
-102067,0,0,0105191010,102067,729,번식용의 것 ,2008.01
-96414,63828,626,0106191000,160242,2211,개,2008.01
-411503,23084,387,0106199000,434587,4411,기타,2008.01
-9183,0,0,0106201000,9183,36,뱀,2008.01
-89525,0,0,0106202000,89525,8290,자라,2008.01
-33920,0,0,0106203000,33920,2262,거북,2008.01
-14430,0,0,0106209000,14430,339,기타,2008.01
-14758,0,0,0106320000,14758,30,앵무류[패럿류(parrots)ㆍ패러키트류(parakeets)ㆍ금강앵무류ㆍ유황앵무류를 포함한다],2008.01
-2618,0,0,0106901000,2618,9,양서류,2008.01
-163840,0,0,0106902090,163840,3354,기타 ,2008.01
-51985,1685,61,0106903010,53670,4342,갯지렁이,2008.01
-6473,0,0,0106903090,6473,1,기타,2008.01
-59228,0,0,0106909000,59228,1119,기타,2008.01
-247550,79600,500,0101101000,327150,4500,말(농가 사육용의 것에 한한다) ,2008.02
-124600,0,0,0101901010,124600,5000,경주말 ,2008.02
-41867,0,0,0101901090,41867,2500,기타 ,2008.02
-237682,0,0,0103100000,237682,14128,번식용,2008.02
-215125,38805,800,0105111000,253930,1791,번식용,2008.02
-164400,0,0,0105191010,164400,1161,번식용의 것 ,2008.02
-105263,40401,498,0106191000,145664,1806,개,2008.02
-6324,0,0,0106192010,6324,15,번식용의 것 ,2008.02
-325594,16060,296,0106199000,341654,3079,기타,2008.02
-14960,0,0,0106201000,14960,36,뱀,2008.02
-105888,0,0,0106202000,105888,8991,자라,2008.02
-30228,16,3,0106203000,30244,1936,거북,2008.02
-10860,0,0,0106209000,10860,68,기타,2008.02
-11393,0,0,0106390000,11393,64,기타,2008.02
-2096,0,0,0106901000,2096,26,양서류,2008.02
-145613,18134,61,0106902090,163747,3198,기타 ,2008.02
-105598,2327,84,0106903010,107925,7581,갯지렁이,2008.02
-10785,0,0,0106903090,10785,11,기타,2008.02
-55,0,0,0106909000,55,0,기타,2008.02
-1064471,0,0,0101101000,1064471,8530,말(농가 사육용의 것에 한한다) ,2008.03
-502809,0,0,0101901010,502809,12485,경주말 ,2008.03
-66598,0,0,0101901090,66598,2500,기타 ,2008.03
-69339,0,0,0103100000,69339,4666,번식용,2008.03
46157,46157,922,0105111000,0,0,번식용,2008.03
21799,21799,332,0105119000,0,0,기타,2008.03
-382892,0,0,0105191010,382892,2992,번식용의 것 ,2008.03
-72217,65365,625,0106191000,137582,2432,개,2008.03
-4042,0,0,0106192090,4042,69,기타 ,2008.03
-405967,15915,293,0106199000,421882,3297,기타,2008.03
-10362,0,0,0106201000,10362,36,뱀,2008.03
-143901,0,0,0106202000,143901,13104,자라,2008.03
-31110,0,0,0106203000,31110,927,거북,2008.03
-1639,0,0,0106209000,1639,102,기타,2008.03
-49607,0,0,0106390000,49607,18,기타,2008.03
-5324,0,0,0106901000,5324,134,양서류,2008.03
-90383,42545,150,0106902090,132928,2666,기타 ,2008.03
-96432,3262,111,0106903010,99694,8663,갯지렁이,2008.03
-4279,0,0,0106903090,4279,10,기타,2008.03
-224,0,0,0106909000,224,2,기타,2008.03
-611945,0,0,0101901010,611945,14000,경주말 ,2008.04
-77208,0,0,0101901090,77208,22050,기타 ,2008.04
-386782,28800,800,0103100000,415582,23561,번식용,2008.04
-86906,0,0,0104201000,86906,4000,젖염소,2008.04
-165000,0,0,0105111000,165000,1056,번식용,2008.04
-93508,0,0,0105119000,93508,2363,기타,2008.04
-451610,0,0,0105191010,451610,2813,번식용의 것 ,2008.04
-505759,0,0,0106110000,505759,352,영장류,2008.04
-103128,44003,676,0106191000,147131,1632,개,2008.04
-7867,0,0,0106192090,7867,68,기타 ,2008.04
-469645,38237,6577,0106199000,507882,4978,기타,2008.04
-8787,0,0,0106201000,8787,73,뱀,2008.04
-140581,0,0,0106202000,140581,12184,자라,2008.04
-25039,0,0,0106203000,25039,807,거북,2008.04
-24835,0,0,0106209000,24835,74,기타,2008.04
-10792,0,0,0106390000,10792,38,기타,2008.04
-9458,0,0,0106901000,9458,148,양서류,2008.04
-161818,34351,120,0106902090,196169,2444,기타 ,2008.04
-24637,4059,152,0106903010,28696,1989,갯지렁이,2008.04
-190,0,0,0106903020,190,190,실지렁이,2008.04
-13103,0,0,0106903090,13103,2,기타,2008.04
-700,0,0,0106909000,700,128,기타,2008.04
-1410353,0,0,0101901010,1410353,25800,경주말 ,2008.05
-632563,15437,1200,0101901090,648000,13500,기타 ,2008.05
-11866,0,0,0101909000,11866,250,기타 ,2008.05
-107750,0,0,0103100000,107750,4590,번식용,2008.05
-352140,0,0,0105111000,352140,1791,번식용,2008.05
-181544,0,0,0105191010,181544,1202,번식용의 것 ,2008.05
-59161,0,0,0106110000,59161,49,영장류,2008.05
-122272,30608,1069,0106191000,152880,2344,개,2008.05
-6235,0,0,0106192090,6235,83,기타 ,2008.05
-14276,0,0,0106194000,14276,630,곰,2008.05
-514007,21227,356,0106199000,535234,4141,기타,2008.05
-20752,0,0,0106201000,20752,91,뱀,2008.05
-146575,4779,200,0106202000,151354,11964,자라,2008.05
-38655,0,0,0106203000,38655,776,거북,2008.05
-15723,0,0,0106209000,15723,42,기타,2008.05
-525,0,0,0106320000,525,15,앵무류[패럿류(parrots)ㆍ패러키트류(parakeets)ㆍ금강앵무류ㆍ유황앵무류를 포함한다],2008.05
4298,4648,153,0106901000,350,5,양서류,2008.05
-132376,0,0,0106902090,132376,2173,기타 ,2008.05
-42721,3338,125,0106903010,46059,4476,갯지렁이,2008.05
-190,0,0,0106903020,190,190,실지렁이,2008.05
-16287,0,0,0106903090,16287,496,기타,2008.05
-477,0,0,0106909000,477,70,기타,2008.05
-1295471,2000,900,0101901010,1297471,14650,경주말 ,2008.06
-131462,0,0,0101901090,131462,7500,기타 ,2008.06
-350557,0,0,0103100000,350557,29040,번식용,2008.06
-249741,0,0,0105191010,249741,1815,번식용의 것 ,2008.06
-12023,0,0,0106110000,12023,30,영장류,2008.06
-183995,21686,752,0106191000,205681,2669,개,2008.06
-6367,0,0,0106192090,6367,88,기타 ,2008.06
-405448,18288,307,0106199000,423736,3963,기타,2008.06
-8382,0,0,0106201000,8382,70,뱀,2008.06
-128282,0,0,0106202000,128282,9906,자라,2008.06
-12045,0,0,0106203000,12045,523,거북,2008.06
-31815,0,0,0106209000,31815,1361,기타,2008.06
-1039,0,0,0106390000,1039,20,기타,2008.06
-1151,1196,45,0106901000,2347,19,양서류,2008.06
-79374,0,0,0106902090,79374,1163,기타 ,2008.06
-84004,3240,151,0106903010,87244,6048,갯지렁이,2008.06
-95,0,0,0106903020,95,95,실지렁이,2008.06
-7746,0,0,0106903090,7746,271,기타,2008.06
-3091,0,0,0106909000,3091,400,기타,2008.06
-1242610,1055,200,0101101000,1243665,18450,말(농가 사육용의 것에 한한다) ,2008.07
-867131,0,0,0101901010,867131,16110,경주말 ,2008.07
-111944,0,0,0101901090,111944,13000,기타 ,2008.07
-37279,93418,18600,0103100000,130697,2820,번식용,2008.07
-1992543,0,0,0105111000,1992543,9391,번식용,2008.07
-254415,0,0,0105191010,254415,1818,번식용의 것 ,2008.07
-461762,0,0,0106110000,461762,340,영장류,2008.07
-153095,24076,1058,0106191000,177171,1857,개,2008.07
-453182,13853,301,0106199000,467035,4268,기타,2008.07
-27487,0,0,0106201000,27487,188,뱀,2008.07
-134982,0,0,0106202000,134982,10065,자라,2008.07
-58305,274,10,0106203000,58579,696,거북,2008.07
-10774,0,0,0106209000,10774,322,기타,2008.07
-79000,0,0,0106390000,79000,60,기타,2008.07
-3846,2501,70,0106901000,6347,33,양서류,2008.07
-19680,77462,184,0106902090,97142,1575,기타 ,2008.07
-151628,21212,427,0106903010,172840,13446,갯지렁이,2008.07
-7486,0,0,0106903090,7486,9,기타,2008.07
-9868,0,0,0106909000,9868,104,기타,2008.07
-73934,15223,1396,0101101000,89157,2000,말(농가 사육용의 것에 한한다) ,2008.08
-271706,0,0,0101901010,271706,7500,경주말 ,2008.08
-181235,0,0,0101901090,181235,4500,기타 ,2008.08
-606200,0,0,0102101000,606200,2932,젖소 ,2008.08
-134050,10800,1580,0103100000,144850,8646,번식용,2008.08
-134996,0,0,0105119000,134996,2887,기타,2008.08
-134194,0,0,0105191010,134194,912,번식용의 것 ,2008.08
-151878,10199,535,0106191000,162077,1742,개,2008.08
-4642,0,0,0106192090,4642,100,기타 ,2008.08
-369283,15357,313,0106199000,384640,3699,기타,2008.08
-539,0,0,0106201000,539,5,뱀,2008.08
-114673,0,0,0106202000,114673,9311,자라,2008.08
-37811,0,0,0106203000,37811,716,거북,2008.08
-14684,0,0,0106209000,14684,380,기타,2008.08
-2199,0,0,0106901000,2199,19,양서류,2008.08
362393,438102,920,0106902090,75709,1000,기타 ,2008.08
-358873,12225,265,0106903010,371098,35436,갯지렁이,2008.08
-18379,0,0,0106903090,18379,124,기타,2008.08
-6778,0,0,0106909000,6778,400,기타,2008.08
-8709,0,0,0101109000,8709,490,기타 ,2008.09
184651,184651,900,0101901010,0,0,경주말 ,2008.09
-37306,0,0,0101901090,37306,1990,기타 ,2008.09
-235000,0,0,0102101000,235000,1638,젖소 ,2008.09
-89845,0,0,0103100000,89845,3708,번식용,2008.09
-545092,0,0,0105111000,545092,2410,번식용,2008.09
-172688,0,0,0105191010,172688,1433,번식용의 것 ,2008.09
-11940,0,0,0106110000,11940,22,영장류,2008.09
-42000,0,0,0106120000,42000,186,"고래ㆍ돌고래류(고래목의 포유동물), 바다소(바다소목의 포유동물) ",2008.09
-176822,8531,444,0106191000,185353,2205,개,2008.09
47,47,2,0106192090,0,0,기타 ,2008.09
15000,15000,1000,0106195090,0,0,기타,2008.09
-426047,30056,539,0106199000,456103,3878,기타,2008.09
-25351,0,0,0106201000,25351,61,뱀,2008.09
-117054,0,0,0106202000,117054,9276,자라,2008.09
-62946,0,0,0106203000,62946,1242,거북,2008.09
-8707,0,0,0106209000,8707,37,기타,2008.09
248,886,7,0106390000,638,40,기타,2008.09
303,385,12,0106901000,82,1,양서류,2008.09
189829,278980,390,0106902090,89151,1648,기타 ,2008.09
-390681,2749,96,0106903010,393430,38298,갯지렁이,2008.09
-8497,0,0,0106903090,8497,7,기타,2008.09
-4835,0,0,0106909000,4835,67,기타,2008.09
-40714,57400,13000,0101101000,98114,2480,말(농가 사육용의 것에 한한다) ,2008.10
-994532,0,0,0101901010,994532,24960,경주말 ,2008.10
-243826,0,0,0101901090,243826,10000,기타 ,2008.10
-1292966,0,0,0103100000,1292966,65482,번식용,2008.10
-2757,0,0,0103920000,2757,210,중량이 50킬로그램 이상인 것,2008.10
-250700,0,0,0105111000,250700,1736,번식용,2008.10
-153954,0,0,0105191010,153954,1126,번식용의 것 ,2008.10
-68961,0,0,0105991010,68961,523,번식용,2008.10
-124750,0,0,0106110000,124750,300,영장류,2008.10
-148190,15785,489,0106191000,163975,2359,개,2008.10
-33000,0,0,0106195010,33000,77,번식용,2008.10
-467073,21850,392,0106199000,488923,3954,기타,2008.10
-7239,0,0,0106201000,7239,5,뱀,2008.10
-112666,0,0,0106202000,112666,9966,자라,2008.10
-17149,0,0,0106203000,17149,2905,거북,2008.10
-1950,0,0,0106390000,1950,32,기타,2008.10
-7280,0,0,0106901000,7280,79,양서류,2008.10
-60359,24105,58,0106902090,84464,1533,기타 ,2008.10
-339057,2699,95,0106903010,341756,35319,갯지렁이,2008.10
-9541,0,0,0106903090,9541,3,기타,2008.10
-8471,0,0,0106909000,8471,105,기타,2008.10
-91520,5980,38,0101101000,97500,1950,말(농가 사육용의 것에 한한다) ,2008.11
-996806,0,0,0101901010,996806,18950,경주말 ,2008.11
-123200,0,0,0101901090,123200,5500,기타 ,2008.11
-269553,0,0,0103100000,269553,14460,번식용,2008.11
-232308,0,0,0105111000,232308,1774,번식용,2008.11
-34039,0,0,0105191010,34039,278,번식용의 것 ,2008.11
-140156,9081,268,0106191000,149237,1812,개,2008.11
-2190,0,0,0106195090,2190,62,기타,2008.11
-417482,19025,334,0106199000,436507,3221,기타,2008.11
-7633,0,0,0106201000,7633,16,뱀,2008.11
-63079,0,0,0106202000,63079,6111,자라,2008.11
-37817,0,0,0106203000,37817,2504,거북,2008.11
-16029,0,0,0106209000,16029,132,기타,2008.11
-3836,0,0,0106320000,3836,78,앵무류[패럿류(parrots)ㆍ패러키트류(parakeets)ㆍ금강앵무류ㆍ유황앵무류를 포함한다],2008.11
-1138,0,0,0106390000,1138,25,기타,2008.11
-4060,0,0,0106901000,4060,130,양서류,2008.11
-72996,470,6,0106902090,73466,1292,기타 ,2008.11
-141407,1999,66,0106903010,143406,15310,갯지렁이,2008.11
-8510,0,0,0106903090,8510,6,기타,2008.11
-2860,0,0,0106909000,2860,122,기타,2008.11
-2482344,0,0,0101101000,2482344,46145,말(농가 사육용의 것에 한한다) ,2008.12
-7800,0,0,0101901010,7800,360,경주말 ,2008.12
-2764809,0,0,0101901090,2764809,3200,기타 ,2008.12
-133027,0,0,0103100000,133027,7402,번식용,2008.12
-68809,0,0,0103920000,68809,1810,중량이 50킬로그램 이상인 것,2008.12
-1073064,0,0,0105111000,1073064,3803,번식용,2008.12
-41885,0,0,0106110000,41885,101,영장류,2008.12
-176845,22740,517,0106191000,199585,2706,개,2008.12
1840,1840,565,0106194000,0,0,곰,2008.12
-2250,0,0,0106195010,2250,35,번식용,2008.12
-329588,28790,5363,0106199000,358378,2847,기타,2008.12
-9825,0,0,0106201000,9825,29,뱀,2008.12
-69109,0,0,0106202000,69109,5603,자라,2008.12
-38223,0,0,0106203000,38223,2628,거북,2008.12
-14080,0,0,0106209000,14080,149,기타,2008.12
-78538,0,0,0106390000,78538,152,기타,2008.12
-10461,0,0,0106901000,10461,650,양서류,2008.12
-127701,657,9,0106902090,128358,2323,기타 ,2008.12
-63769,1621,56,0106903010,65390,6648,갯지렁이,2008.12
-17119,0,0,0106903090,17119,10,기타,2008.12
-2640,0,0,0106909000,2640,509,기타,2008.12
-43022854,2225964,69830,-,45248818,992941,-,총계
-407762,5298,36,0101101000,413060,4000,말(농가 사육용의 것에 한한다) ,2009.01
53797,806215,400,0101901010,752418,15500,경주말 ,2009.01
-151673,0,0,0101901090,151673,6700,기타 ,2009.01
-114090,0,0,0103100000,114090,7912,번식용,2009.01
-5674,0,0,0103910000,5674,45,중량이 50킬로그램 미만인 것,2009.01
-704700,0,0,0105111000,704700,2312,번식용,2009.01
-32284,15220,289,0106191000,47504,804,개,2009.01
-1500,0,0,0106195090,1500,100,기타,2009.01
-383514,18208,275,0106199000,401722,2545,기타,2009.01
-6044,0,0,0106201000,6044,29,뱀,2009.01
-71087,0,0,0106202000,71087,7235,자라,2009.01
-41050,0,0,0106203000,41050,2466,거북,2009.01
-3529,0,0,0106209000,3529,15,기타,2009.01
-7476,0,0,0106901000,7476,2222,양서류,2009.01
-54614,20250,34,0106902090,74864,1210,기타 ,2009.01
-49590,1866,63,0106903010,51456,5484,갯지렁이,2009.01
-82,0,0,0106903090,82,2,기타,2009.01
-3681,0,0,0106909000,3681,193,기타,2009.01
1164,1164,12,0101101000,0,0,말(농가 사육용의 것에 한한다) ,2009.02
-75014,0,0,0101901090,75014,10700,기타 ,2009.02
-190112,0,0,0105111000,190112,1774,번식용,2009.02
-26074,0,0,0105191010,26074,226,번식용의 것 ,2009.02
-86069,14543,218,0106191000,100612,1371,개,2009.02
-478540,18906,314,0106199000,497446,3578,기타,2009.02
-1854,0,0,0106201000,1854,7,뱀,2009.02
-91098,0,0,0106202000,91098,7975,자라,2009.02
-22605,0,0,0106203000,22605,2040,거북,2009.02
-8437,0,0,0106209000,8437,33,기타,2009.02
-2797,0,0,0106310000,2797,7,맹금류,2009.02
-1014,0,0,0106390000,1014,70,기타,2009.02
-2966,0,0,0106901000,2966,34,양서류,2009.02
-68866,41262,60,0106902090,110128,1025,기타 ,2009.02
-46621,1445,49,0106903010,48066,5172,갯지렁이,2009.02
-4158,0,0,0106903090,4158,17,기타,2009.02
-2981,0,0,0106909000,2981,56,기타,2009.02
-612925,0,0,0101101000,612925,3334,말(농가 사육용의 것에 한한다) ,2009.03
-6200,6382,500,0101901010,12582,500,경주말 ,2009.03
133,133,30,0102102000,0,0,육우 ,2009.03
-155212,0,0,0105191010,155212,1559,번식용의 것 ,2009.03
-155399,12782,366,0106191000,168181,1998,개,2009.03
-123,0,0,0106192090,123,3,기타 ,2009.03
-2300,0,0,0106195090,2300,52,기타,2009.03
-337897,20243,402,0106199000,358140,3560,기타,2009.03
-6466,0,0,0106201000,6466,13,뱀,2009.03
-97938,0,0,0106202000,97938,10448,자라,2009.03
-48630,0,0,0106203000,48630,1060,거북,2009.03
-6892,0,0,0106209000,6892,21,기타,2009.03
-601,0,0,0106310000,601,2,맹금류,2009.03
-2168,0,0,0106320000,2168,25,앵무류[패럿류(parrots)ㆍ패러키트류(parakeets)ㆍ금강앵무류ㆍ유황앵무류를 포함한다],2009.03
-60,0,0,0106390000,60,6,기타,2009.03
-3349,0,0,0106901000,3349,71,양서류,2009.03
-108125,4497,30,0106902090,112622,1634,기타 ,2009.03
-56707,2218,74,0106903010,58925,6117,갯지렁이,2009.03
-95,0,0,0106903020,95,95,실지렁이,2009.03
-123,0,0,0106903090,123,3,기타,2009.03
-3729,0,0,0106909000,3729,65,기타,2009.03
17178,17199,20,0101101000,21,1,말(농가 사육용의 것에 한한다) ,2009.04
-102461,0,0,0101901090,102461,9650,기타 ,2009.04
-55982,0,0,0103100000,55982,4450,번식용,2009.04
-314751,0,0,0105191010,314751,3330,번식용의 것 ,2009.04
-215532,0,0,0106110000,215532,300,영장류,2009.04
-109277,22464,765,0106191000,131741,1732,개,2009.04
-390341,34281,597,0106199000,424622,4325,기타,2009.04
-4957,0,0,0106201000,4957,183,뱀,2009.04
-58331,0,0,0106202000,58331,6622,자라,2009.04
-32321,0,0,0106203000,32321,868,거북,2009.04
-30226,0,0,0106209000,30226,1108,기타,2009.04
-6224,0,0,0106320000,6224,20,앵무류[패럿류(parrots)ㆍ패러키트류(parakeets)ㆍ금강앵무류ㆍ유황앵무류를 포함한다],2009.04
-12023,0,0,0106390000,12023,40,기타,2009.04
-4385,3874,100,0106901000,8259,88,양서류,2009.04
-78289,0,0,0106902090,78289,1187,기타 ,2009.04
-37818,4216,135,0106903010,42034,3796,갯지렁이,2009.04
-3509,0,0,0106903020,3509,2545,실지렁이,2009.04
-14997,0,0,0106903090,14997,11,기타,2009.04
-4136,0,0,0106909000,4136,57,기타,2009.04
-129985,0,0,0101101000,129985,2300,말(농가 사육용의 것에 한한다) ,2009.05
-1694807,0,0,0101901010,1694807,33500,경주말 ,2009.05
-191866,0,0,0101901090,191866,6900,기타 ,2009.05
-144022,0,0,0103100000,144022,10016,번식용,2009.05
-352684,0,0,0105111000,352684,2131,번식용,2009.05
-354080,0,0,0105191010,354080,3912,번식용의 것 ,2009.05
-553500,0,0,0106110000,553500,900,영장류,2009.05
-61972,0,0,0106120000,61972,120,"고래ㆍ돌고래류(고래목의 포유동물), 바다소(바다소목의 포유동물) ",2009.05
-141008,19447,685,0106191000,160455,2001,개,2009.05
207,217,20,0106192090,10,3,기타 ,2009.05
-6550,0,0,0106195090,6550,75,기타,2009.05
-355827,25375,482,0106199000,381202,3757,기타,2009.05
-16723,0,0,0106201000,16723,139,뱀,2009.05
-109026,0,0,0106202000,109026,10770,자라,2009.05
-13430,0,0,0106203000,13430,433,거북,2009.05
-11623,0,0,0106209000,11623,149,기타,2009.05
-82,12,9,0106390000,94,8,기타,2009.05
5489,8747,230,0106901000,3258,35,양서류,2009.05
-52043,46088,85,0106902090,98131,2746,기타 ,2009.05
-91853,4564,143,0106903010,96417,7610,갯지렁이,2009.05
-462,0,0,0106903020,462,210,실지렁이,2009.05
-753,0,0,0106903090,753,8,기타,2009.05
-8355,0,0,0106909000,8355,81,기타,2009.05
151,151,27,0101101000,0,0,말(농가 사육용의 것에 한한다) ,2009.06
-392925,0,0,0101901090,392925,15500,기타 ,2009.06
770000,770000,1240,0103910000,0,0,중량이 50킬로그램 미만인 것,2009.06
-109963,0,0,0105111000,109963,624,번식용,2009.06
-108244,0,0,0105191010,108244,1093,번식용의 것 ,2009.06
-58200,0,0,0106110000,58200,186,영장류,2009.06
-94360,0,0,0106120000,94360,725,"고래ㆍ돌고래류(고래목의 포유동물), 바다소(바다소목의 포유동물) ",2009.06
-102131,28901,1104,0106191000,131032,1863,개,2009.06
320,320,3,0106192090,0,0,기타 ,2009.06
-6370,0,0,0106195090,6370,20,기타,2009.06
-507643,21015,409,0106199000,528658,5068,기타,2009.06
-23414,0,0,0106201000,23414,1914,뱀,2009.06
-77203,0,0,0106202000,77203,8410,자라,2009.06
-25452,0,0,0106203000,25452,467,거북,2009.06
-13367,0,0,0106209000,13367,68,기타,2009.06
-38990,0,0,0106320000,38990,182,앵무류[패럿류(parrots)ㆍ패러키트류(parakeets)ㆍ금강앵무류ㆍ유황앵무류를 포함한다],2009.06
2409,8459,200,0106901000,6050,38,양서류,2009.06
-58435,17136,20,0106902090,75571,1653,기타 ,2009.06
-105757,4616,145,0106903010,110373,8853,갯지렁이,2009.06
-946,0,0,0106903020,946,200,실지렁이,2009.06
-865,4,10,0106903090,869,279,기타,2009.06
-2736,0,0,0106909000,2736,670,기타,2009.06
-504765,0,0,0101101000,504765,20700,말(농가 사육용의 것에 한한다) ,2009.07
-1557346,0,0,0101901010,1557346,23500,경주말 ,2009.07
-287888,0,0,0101901090,287888,8300,기타 ,2009.07
-2263244,0,0,0105111000,2263244,11797,번식용,2009.07
-286299,0,0,0105191010,286299,3051,번식용의 것 ,2009.07
-58357,0,0,0105991010,58357,437,번식용,2009.07
-64978,0,0,0106120000,64978,225,"고래ㆍ돌고래류(고래목의 포유동물), 바다소(바다소목의 포유동물) ",2009.07
-147476,24942,651,0106191000,172418,2875,개,2009.07
-424705,15180,288,0106199000,439885,4301,기타,2009.07
-18990,0,0,0106201000,18990,229,뱀,2009.07
-132680,0,0,0106202000,132680,13309,자라,2009.07
-84188,0,0,0106203000,84188,635,거북,2009.07
-28319,0,0,0106209000,28319,974,기타,2009.07
-53393,0,0,0106320000,53393,243,앵무류[패럿류(parrots)ㆍ패러키트류(parakeets)ㆍ금강앵무류ㆍ유황앵무류를 포함한다],2009.07
-5333,0,0,0106901000,5333,93,양서류,2009.07
3241,55152,22,0106902090,51911,1431,기타 ,2009.07
-156942,7131,222,0106903010,164073,14240,갯지렁이,2009.07
-10414,0,0,0106903090,10414,101,기타,2009.07
-2703,0,0,0106909000,2703,54,기타,2009.07
-42,0,0,0101101000,42,1,말(농가 사육용의 것에 한한다) ,2009.08
-176300,0,0,0101901090,176300,5250,기타 ,2009.08
-504071,0,0,0105111000,504071,3197,번식용,2009.08
-100495,0,0,0105119000,100495,4000,기타,2009.08
-330099,0,0,0105191010,330099,2917,번식용의 것 ,2009.08
-433650,0,0,0106110000,433650,1300,영장류,2009.08
-80490,20434,826,0106191000,100924,1928,개,2009.08
368,368,4,0106192010,0,0,번식용의 것 ,2009.08
-364840,21726,386,0106199000,386566,3834,기타,2009.08
-1905,0,0,0106201000,1905,180,뱀,2009.08
-95808,0,0,0106202000,95808,9319,자라,2009.08
-43655,0,0,0106203000,43655,614,거북,2009.08
-3509,0,0,0106209000,3509,69,기타,2009.08
-40763,0,0,0106320000,40763,163,앵무류[패럿류(parrots)ㆍ패러키트류(parakeets)ㆍ금강앵무류ㆍ유황앵무류를 포함한다],2009.08
-992,0,0,0106390000,992,33,기타,2009.08
-7363,0,0,0106901000,7363,32,양서류,2009.08
99241,164569,240,0106902090,65328,1276,기타 ,2009.08
-412751,4417,140,0106903010,417168,38403,갯지렁이,2009.08
-2086,0,0,0106903090,2086,71,기타,2009.08
-1658,0,0,0106909000,1658,259,기타,2009.08
-662405,0,0,0101901010,662405,13489,경주말 ,2009.09
-340736,0,0,0101901090,340736,9000,기타 ,2009.09
-985000,0,0,0102101000,985000,5100,젖소 ,2009.09
-112339,0,0,0105191010,112339,908,번식용의 것 ,2009.09
-134957,28958,609,0106191000,163915,2587,개,2009.09
-498,0,0,0106192090,498,5,기타 ,2009.09
-1300,0,0,0106195090,1300,55,기타,2009.09
-446697,33487,588,0106199000,480184,4399,기타,2009.09
-4865,0,0,0106201000,4865,82,뱀,2009.09
-79654,0,0,0106202000,79654,8325,자라,2009.09
-48260,0,0,0106203000,48260,669,거북,2009.09
-18875,0,0,0106209000,18875,156,기타,2009.09
-48280,0,0,0106320000,48280,308,앵무류[패럿류(parrots)ㆍ패러키트류(parakeets)ㆍ금강앵무류ㆍ유황앵무류를 포함한다],2009.09
-56,0,0,0106390000,56,5,기타,2009.09
-1120,0,0,0106901000,1120,30,양서류,2009.09
37333,111066,137,0106902090,73733,1439,기타 ,2009.09
-268676,4668,149,0106903010,273344,26056,갯지렁이,2009.09
-2973,0,0,0106903090,2973,4,기타,2009.09
-6225,0,0,0106909000,6225,108,기타,2009.09
29306,29308,368,0101101000,2,1,말(농가 사육용의 것에 한한다) ,2009.10
-141831,0,0,0101901090,141831,6500,기타 ,2009.10
-387371,0,0,0105111000,387371,2316,번식용,2009.10
-227451,0,0,0105119000,227451,3162,기타,2009.10
-369979,0,0,0105191010,369979,3221,번식용의 것 ,2009.10
-488100,0,0,0106110000,488100,938,영장류,2009.10
-241792,0,0,0106120000,241792,1239,"고래ㆍ돌고래류(고래목의 포유동물), 바다소(바다소목의 포유동물) ",2009.10
-85679,16608,193,0106191000,102287,1357,개,2009.10
-449732,36757,574,0106199000,486489,3741,기타,2009.10
-1817,0,0,0106201000,1817,11,뱀,2009.10
-102497,0,0,0106202000,102497,10426,자라,2009.10
-32257,300,2,0106203000,32557,356,거북,2009.10
-22334,0,0,0106209000,22334,284,기타,2009.10
-234,0,0,0106310000,234,3,맹금류,2009.10
-9771,0,0,0106320000,9771,57,앵무류[패럿류(parrots)ㆍ패러키트류(parakeets)ㆍ금강앵무류ㆍ유황앵무류를 포함한다],2009.10
-4025,0,0,0106390000,4025,10,기타,2009.10
-2567,0,0,0106901000,2567,34,양서류,2009.10
-24968,29673,64,0106902090,54641,892,기타 ,2009.10
-304625,2433,78,0106903010,307058,30045,갯지렁이,2009.10
-3266,0,0,0106903090,3266,8,기타,2009.10
-2877,0,0,0106909000,2877,84,기타,2009.10
-45825,25500,168,0101101000,71325,2500,말(농가 사육용의 것에 한한다) ,2009.11
-815730,0,0,0101901010,815730,13000,경주말 ,2009.11
-310434,0,0,0103100000,310434,19620,번식용,2009.11
-168263,0,0,0105111000,168263,3078,번식용,2009.11
-75969,0,0,0105119000,75969,1054,기타,2009.11
-267932,0,0,0105191010,267932,2405,번식용의 것 ,2009.11
-127500,0,0,0106120000,127500,465,"고래ㆍ돌고래류(고래목의 포유동물), 바다소(바다소목의 포유동물) ",2009.11
-82342,21143,187,0106191000,103485,1496,개,2009.11
-12151,0,0,0106195090,12151,77,기타,2009.11
-413389,25354,393,0106199000,438743,4338,기타,2009.11
-5326,0,0,0106201000,5326,10,뱀,2009.11
-76740,0,0,0106202000,76740,8056,자라,2009.11
-62001,0,0,0106203000,62001,629,거북,2009.11
-20439,0,0,0106209000,20439,93,기타,2009.11
-59920,0,0,0106320000,59920,340,앵무류[패럿류(parrots)ㆍ패러키트류(parakeets)ㆍ금강앵무류ㆍ유황앵무류를 포함한다],2009.11
-16266,0,0,0106390000,16266,82,기타,2009.11
-3131,0,0,0106901000,3131,150,양서류,2009.11
-1985,57917,105,0106902090,59902,1045,기타 ,2009.11
-118189,1279,41,0106903010,119468,11738,갯지렁이,2009.11
-13564,0,0,0106903090,13564,14,기타,2009.11
-3608,0,0,0106909000,3608,22,기타,2009.11
-2368216,0,0,0101101000,2368216,57000,말(농가 사육용의 것에 한한다) ,2009.12
-830725,0,0,0101901010,830725,19350,경주말 ,2009.12
-2292090,0,0,0101901090,2292090,1600,기타 ,2009.12
-59400,0,0,0103100000,59400,3870,번식용,2009.12
-672633,0,0,0105111000,672633,2361,번식용,2009.12
-216700,0,0,0105191010,216700,1866,번식용의 것 ,2009.12
-13324,0,0,0106110000,13324,28,영장류,2009.12
-93536,23846,321,0106191000,117382,1092,개,2009.12
-9968,0,0,0106195090,9968,150,기타,2009.12
-403811,36076,604,0106199000,439887,3798,기타,2009.12
-3491,0,0,0106201000,3491,26,뱀,2009.12
-101654,0,0,0106202000,101654,10117,자라,2009.12
-11727,0,0,0106203000,11727,351,거북,2009.12
-275,0,0,0106209000,275,4,기타,2009.12
-39622,0,0,0106320000,39622,141,앵무류[패럿류(parrots)ㆍ패러키트류(parakeets)ㆍ금강앵무류ㆍ유황앵무류를 포함한다],2009.12
-14098,0,0,0106901000,14098,1944,양서류,2009.12
-68968,11140,89,0106902090,80108,1373,기타 ,2009.12
-73040,1664,53,0106903010,74704,6618,갯지렁이,2009.12
-3489,0,0,0106903090,3489,4,기타,2009.12
-1000,0,0,0106909000,1000,100,기타,2009.12
-35958427,2838814,17078,-,38797241,798111,-,총계
-59000,0,0,0101101000,59000,1500,말(농가 사육용의 것에 한한다) ,2010.01
-235073,0,0,0101901010,235073,600,경주말 ,2010.01
-2059932,0,0,0101901090,2059932,6450,기타 ,2010.01
-1141929,0,0,0103100000,1141929,76493,번식용,2010.01
-1341468,0,0,0105111000,1341468,4440,번식용,2010.01
-22751,0,0,0105191010,22751,226,번식용의 것 ,2010.01
-39839,0,0,0106110000,39839,60,영장류,2010.01
-33037,0,0,0106120000,33037,60,"고래ㆍ돌고래류(고래목의 포유동물), 바다소(바다소목의 포유동물) ",2010.01
-66618,26329,258,0106191000,92947,1179,개,2010.01
-80,0,0,0106192090,80,10,기타 ,2010.01
-382367,27636,394,0106199000,410003,3048,기타,2010.01
-654,0,0,0106201000,654,90,뱀,2010.01
-39437,0,0,0106202000,39437,4457,자라,2010.01
-30843,0,0,0106203000,30843,527,거북,2010.01
-2740,0,0,0106209000,2740,8,기타,2010.01
-2883,0,0,0106901000,2883,121,양서류,2010.01
-39817,19321,50,0106902090,59138,1138,기타 ,2010.01
-52739,1379,43,0106903010,54118,4793,갯지렁이,2010.01
-470,0,0,0106903090,470,3,기타,2010.01
-9932,0,0,0106909000,9932,13,기타,2010.01
-22682,0,0,0101101000,22682,500,말(농가 사육용의 것에 한한다) ,2010.02
-185730,0,0,0101901090,185730,4050,기타 ,2010.02
-413434,0,0,0103100000,413434,27250,번식용,2010.02
-218462,0,0,0105191010,218462,2230,번식용의 것 ,2010.02
-297000,0,0,0106110000,297000,800,영장류,2010.02
-124148,18663,155,0106191000,142811,1798,개,2010.02
200,200,4,0106192090,0,0,기타 ,2010.02
-384103,17700,260,0106199000,401803,3029,기타,2010.02
-2398,0,0,0106201000,2398,10,뱀,2010.02
-54738,0,0,0106202000,54738,6340,자라,2010.02
-47301,0,0,0106203000,47301,3695,거북,2010.02
-3803,0,0,0106209000,3803,14,기타,2010.02
-8627,0,0,0106320000,8627,33,앵무류[패럿류(parrots)ㆍ패러키트류(parakeets)ㆍ금강앵무류ㆍ유황앵무류를 포함한다],2010.02
-2940,0,0,0106390000,2940,41,기타,2010.02
-3560,0,0,0106901000,3560,134,양서류,2010.02
-57369,9551,50,0106902090,66920,1013,기타 ,2010.02
-56620,1667,53,0106903010,58287,5228,갯지렁이,2010.02
-9116,0,0,0106903090,9116,5,기타,2010.02
-1516,0,0,0106909000,1516,2,기타,2010.02
-251950,0,0,0101101000,251950,6000,말(농가 사육용의 것에 한한다) ,2010.03
-615052,0,0,0101901010,615052,4150,경주말 ,2010.03
-310543,0,0,0101901090,310543,9800,기타 ,2010.03
-89588,0,0,0103100000,89588,3494,번식용,2010.03
-285178,14735,89,0105111000,299913,2108,번식용,2010.03
-431113,0,0,0105191010,431113,4242,번식용의 것 ,2010.03
-125224,23582,367,0106191000,148806,1699,개,2010.03
-6601,0,0,0106195090,6601,123,기타,2010.03
-476777,29799,534,0106199000,506576,3688,기타,2010.03
-1200,0,0,0106201000,1200,3,뱀,2010.03
-82390,0,0,0106202000,82390,8670,자라,2010.03
-90753,0,0,0106203000,90753,1058,거북,2010.03
-20990,0,0,0106209000,20990,347,기타,2010.03
-30825,0,0,0106320000,30825,177,앵무류[패럿류(parrots)ㆍ패러키트류(parakeets)ㆍ금강앵무류ㆍ유황앵무류를 포함한다],2010.03
-3350,0,0,0106901000,3350,21,양서류,2010.03
-42098,54208,115,0106902090,96306,1580,기타 ,2010.03
-63378,3044,93,0106903010,66422,6297,갯지렁이,2010.03
-8329,0,0,0106903090,8329,32,기타,2010.03
-2442,0,0,0106909000,2442,102,기타,2010.03
-565851,0,0,0101901010,565851,8200,경주말 ,2010.04
-66784,0,0,0103100000,66784,4700,번식용,2010.04
60854,60854,1500,0103910000,0,0,중량이 50킬로그램 미만인 것,2010.04
-160347,0,0,0105111000,160347,1095,번식용,2010.04
-367677,0,0,0105191010,367677,3854,번식용의 것 ,2010.04
-308000,0,0,0106110000,308000,750,영장류,2010.04
-134936,29209,691,0106191000,164145,1918,개,2010.04
-500,0,0,0106192090,500,5,기타 ,2010.04
-977,0,0,0106195090,977,10,기타,2010.04
-403884,43653,727,0106199000,447537,3574,기타,2010.04
-11463,0,0,0106201000,11463,265,뱀,2010.04
-98566,0,0,0106202000,98566,10754,자라,2010.04
-35146,0,0,0106203000,35146,727,거북,2010.04
-23470,0,0,0106209000,23470,732,기타,2010.04
-18946,0,0,0106320000,18946,27,앵무류[패럿류(parrots)ㆍ패러키트류(parakeets)ㆍ금강앵무류ㆍ유황앵무류를 포함한다],2010.04
-739,0,0,0106390000,739,10,기타,2010.04
-3613,0,0,0106901000,3613,26,양서류,2010.04
16414,82734,152,0106902090,66320,1620,기타 ,2010.04
-88240,2252,69,0106903010,90492,8884,갯지렁이,2010.04
-7687,0,0,0106903090,7687,6,기타,2010.04
-1000,0,0,0106909000,1000,95,기타,2010.04
2468,2468,85,0101101000,0,0,말(농가 사육용의 것에 한한다) ,2010.05
-3175373,0,0,0101901010,3175373,55300,경주말 ,2010.05
-311727,0,0,0101901090,311727,11100,기타 ,2010.05
-332625,0,0,0103100000,332625,12830,번식용,2010.05
-387099,0,0,0105191010,387099,3392,번식용의 것 ,2010.05
-255500,0,0,0106110000,255500,725,영장류,2010.05
-194214,22615,699,0106191000,216829,2737,개,2010.05
150,150,2,0106192090,0,0,기타 ,2010.05
-406042,24392,449,0106199000,430434,2998,기타,2010.05
-9593,0,0,0106201000,9593,33,뱀,2010.05
-95391,0,0,0106202000,95391,9608,자라,2010.05
-37851,0,0,0106203000,37851,390,거북,2010.05
-37507,0,0,0106209000,37507,105,기타,2010.05
-38359,0,0,0106320000,38359,25,앵무류[패럿류(parrots)ㆍ패러키트류(parakeets)ㆍ금강앵무류ㆍ유황앵무류를 포함한다],2010.05
9,9,8,0106390000,0,0,기타,2010.05
10472,17721,290,0106901000,7249,54,양서류,2010.05
16331,72199,388,0106902090,55868,1816,기타 ,2010.05
-146750,4286,132,0106903010,151036,14473,갯지렁이,2010.05
-11803,0,0,0106903090,11803,3,기타,2010.05
-5424,0,0,0106909000,5424,132,기타,2010.05
-1891690,0,0,0101901010,1891690,18462,경주말 ,2010.06
-727888,0,0,0101901090,727888,21287,기타 ,2010.06
-150050,0,0,0103100000,150050,9501,번식용,2010.06
-93474,0,0,0105111000,93474,2280,번식용,2010.06
-358512,0,0,0105191010,358512,4164,번식용의 것 ,2010.06
-33284,0,0,0105991010,33284,550,번식용,2010.06
-75950,0,0,0106110000,75950,200,영장류,2010.06
-95376,27982,858,0106191000,123358,1868,개,2010.06
-339158,23814,476,0106199000,362972,3217,기타,2010.06
-8364,0,0,0106201000,8364,120,뱀,2010.06
-122438,0,0,0106202000,122438,12874,자라,2010.06
-20284,0,0,0106203000,20284,486,거북,2010.06
-24533,0,0,0106209000,24533,160,기타,2010.06
-21644,0,0,0106320000,21644,139,앵무류[패럿류(parrots)ㆍ패러키트류(parakeets)ㆍ금강앵무류ㆍ유황앵무류를 포함한다],2010.06
-2188,0,0,0106390000,2188,16,기타,2010.06
-8413,0,0,0106901000,8413,47,양서류,2010.06
59498,118467,926,0106902090,58969,1089,기타 ,2010.06
-312919,6064,195,0106903010,318983,31272,갯지렁이,2010.06
-7683,0,0,0106903090,7683,6,기타,2010.06
-1318143,0,0,0101901010,1318143,22850,경주말 ,2010.07
-481545,0,0,0101901090,481545,11000,기타 ,2010.07
-16665,0,0,0101909000,16665,1000,기타 ,2010.07
-584547,0,0,0103100000,584547,28003,번식용,2010.07
-1611533,1997,220,0105111000,1613530,6101,번식용,2010.07
-623441,0,0,0105191010,623441,6642,번식용의 것 ,2010.07
-172000,0,0,0106110000,172000,500,영장류,2010.07
-170659,19094,492,0106191000,189753,2413,개,2010.07
157,250,12,0106192090,93,3,기타 ,2010.07
-461791,31279,640,0106199000,493070,9565,기타,2010.07
-4427,0,0,0106201000,4427,53,뱀,2010.07
-117827,0,0,0106202000,117827,11967,자라,2010.07
-75154,0,0,0106203000,75154,392,거북,2010.07
-5665,0,0,0106209000,5665,13,기타,2010.07
-22453,0,0,0106320000,22453,74,앵무류[패럿류(parrots)ㆍ패러키트류(parakeets)ㆍ금강앵무류ㆍ유황앵무류를 포함한다],2010.07
-6458,0,0,0106390000,6458,50,기타,2010.07
-5651,0,0,0106901000,5651,29,양서류,2010.07
42843,89743,505,0106902090,46900,829,기타 ,2010.07
-395466,16866,359,0106903010,412332,39940,갯지렁이,2010.07
-10181,0,0,0106903090,10181,6,기타,2010.07
-2794,0,0,0106909000,2794,223,기타,2010.07
-25338,0,0,0101901090,25338,500,기타 ,2010.08
-534000,0,0,0102101000,534000,2700,젖소 ,2010.08
-505100,0,0,0105111000,505100,1804,번식용,2010.08
-357082,0,0,0105191010,357082,3575,번식용의 것 ,2010.08
-46649,0,0,0105991010,46649,481,번식용,2010.08
-183707,19926,685,0106191000,203633,2500,개,2010.08
180,180,13,0106192090,0,0,기타 ,2010.08
-448125,31178,617,0106199000,479303,4479,기타,2010.08
-14735,0,0,0106201000,14735,59,뱀,2010.08
-87869,0,0,0106202000,87869,8689,자라,2010.08
-35411,0,0,0106203000,35411,416,거북,2010.08
-16891,0,0,0106209000,16891,122,기타,2010.08
-19867,0,0,0106320000,19867,77,앵무류[패럿류(parrots)ㆍ패러키트류(parakeets)ㆍ금강앵무류ㆍ유황앵무류를 포함한다],2010.08
-6888,0,0,0106390000,6888,78,기타,2010.08
-5549,0,0,0106901000,5549,47,양서류,2010.08
53275,94620,615,0106902090,41345,1147,기타 ,2010.08
-393620,10308,218,0106903010,403928,39312,갯지렁이,2010.08
-1200,0,0,0106909000,1200,30,기타,2010.08
-77517,0,0,0101901090,77517,3000,기타 ,2010.09
-330000,0,0,0102101000,330000,1500,젖소 ,2010.09
-603813,0,0,0103100000,603813,29950,번식용,2010.09
-241000,0,0,0105111000,241000,1169,번식용,2010.09
-300575,0,0,0105191010,300575,3141,번식용의 것 ,2010.09
-374350,0,0,0106110000,374350,1005,영장류,2010.09
-258949,21908,751,0106191000,280857,4020,개,2010.09
-382624,35234,755,0106199000,417858,3828,기타,2010.09
-11953,0,0,0106201000,11953,36,뱀,2010.09
-76718,0,0,0106202000,76718,7791,자라,2010.09
-43544,0,0,0106203000,43544,514,거북,2010.09
-6388,0,0,0106209000,6388,68,기타,2010.09
-28929,0,0,0106320000,28929,45,앵무류[패럿류(parrots)ㆍ패러키트류(parakeets)ㆍ금강앵무류ㆍ유황앵무류를 포함한다],2010.09
-4842,0,0,0106390000,4842,30,기타,2010.09
-8646,0,0,0106901000,8646,33,양서류,2010.09
97659,142282,470,0106902090,44623,1146,기타 ,2010.09
-403003,12161,228,0106903010,415164,41342,갯지렁이,2010.09
-11458,0,0,0106903090,11458,7,기타,2010.09
-84248,0,0,0101101000,84248,1000,말(농가 사육용의 것에 한한다) ,2010.10
-2759623,0,0,0101109000,2759623,1200,기타 ,2010.10
-185619,0,0,0101901010,185619,5000,경주말 ,2010.10
-546848,0,0,0101901090,546848,16920,기타 ,2010.10
-172470,0,0,0103100000,172470,7300,번식용,2010.10
52829,52829,1700,0103910000,0,0,중량이 50킬로그램 미만인 것,2010.10
-380052,0,0,0105111000,380052,1332,번식용,2010.10
-264737,0,0,0105191010,264737,2561,번식용의 것 ,2010.10
-46544,0,0,0105991010,46544,470,번식용,2010.10
-187713,18950,654,0106191000,206663,4053,개,2010.10
-45505,0,0,0106192010,45505,1200,번식용의 것 ,2010.10
-187,0,0,0106195090,187,30,기타,2010.10
-711931,38762,541,0106199000,750693,8790,기타,2010.10
-12059,0,0,0106201000,12059,335,뱀,2010.10
-131501,0,0,0106202000,131501,12844,자라,2010.10
-67816,0,0,0106203000,67816,590,거북,2010.10
-26275,0,0,0106209000,26275,231,기타,2010.10
-19250,0,0,0106320000,19250,32,앵무류[패럿류(parrots)ㆍ패러키트류(parakeets)ㆍ금강앵무류ㆍ유황앵무류를 포함한다],2010.10
-9342,0,0,0106390000,9342,148,기타,2010.10
-4856,0,0,0106901000,4856,236,양서류,2010.10
45634,96503,275,0106902090,50869,1576,기타 ,2010.10
-233643,8277,224,0106903010,241920,24474,갯지렁이,2010.10
-11750,0,0,0106903090,11750,28,기타,2010.10
-3850,0,0,0106909000,3850,90,기타,2010.10
-119344,0,0,0101101000,119344,3450,말(농가 사육용의 것에 한한다) ,2010.11
-935410,0,0,0101901010,935410,16800,경주말 ,2010.11
18979,95073,500,0101901090,76094,600,기타 ,2010.11
-5746,0,0,0101909000,5746,3450,기타 ,2010.11
-173179,0,0,0103100000,173179,11415,번식용,2010.11
-250508,0,0,0105111000,250508,1772,번식용,2010.11
-193196,0,0,0105191010,193196,1921,번식용의 것 ,2010.11
-177404,0,0,0106110000,177404,584,영장류,2010.11
-43750,0,0,0106120000,43750,450,"고래ㆍ돌고래류(고래목의 포유동물), 바다소(바다소목의 포유동물) ",2010.11
-160968,24919,633,0106191000,185887,2275,개,2010.11
-125001,0,0,0106194000,125001,330,곰,2010.11
-487,0,0,0106195090,487,30,기타,2010.11
-513890,32934,500,0106199000,546824,3878,기타,2010.11
-4298,0,0,0106201000,4298,29,뱀,2010.11
-65963,0,0,0106202000,65963,6869,자라,2010.11
-44082,0,0,0106203000,44082,459,거북,2010.11
-8104,0,0,0106209000,8104,12,기타,2010.11
-22168,0,0,0106320000,22168,89,앵무류[패럿류(parrots)ㆍ패러키트류(parakeets)ㆍ금강앵무류ㆍ유황앵무류를 포함한다],2010.11
-1212,0,0,0106390000,1212,11,기타,2010.11
-6686,0,0,0106901000,6686,35,양서류,2010.11
-33799,30127,128,0106902090,63926,1817,기타 ,2010.11
-226815,4294,126,0106903010,231109,23027,갯지렁이,2010.11
-2496,0,0,0106903090,2496,3,기타,2010.11
-2162805,0,0,0101101000,2162805,50900,말(농가 사육용의 것에 한한다) ,2010.12
-719661,0,0,0101901010,719661,14960,경주말 ,2010.12
-397948,0,0,0101901090,397948,4150,기타 ,2010.12
-423077,0,0,0103100000,423077,19811,번식용,2010.12
-55331,0,0,0103920000,55331,1955,중량이 50킬로그램 이상인 것,2010.12
-1286654,11474,89,0105111000,1298128,4083,번식용,2010.12
-106800,0,0,0105191010,106800,1124,번식용의 것 ,2010.12
-16076,0,0,0106120000,16076,40,"고래ㆍ돌고래류(고래목의 포유동물), 바다소(바다소목의 포유동물) ",2010.12
-136036,28587,630,0106191000,164623,1807,개,2010.12
-44616,0,0,0106192010,44616,950,번식용의 것 ,2010.12
-3006,50,2,0106192090,3056,54,기타 ,2010.12
-401180,25028,516,0106199000,426208,3736,기타,2010.12
-16259,0,0,0106201000,16259,324,뱀,2010.12
-85875,0,0,0106202000,85875,8826,자라,2010.12
-41959,90,3,0106203000,42049,482,거북,2010.12
-11786,0,0,0106209000,11786,27,기타,2010.12
-24465,0,0,0106320000,24465,44,앵무류[패럿류(parrots)ㆍ패러키트류(parakeets)ㆍ금강앵무류ㆍ유황앵무류를 포함한다],2010.12
-57878,0,0,0106390000,57878,209,기타,2010.12
-4851,0,0,0106901000,4851,764,양서류,2010.12
-36241,16048,125,0106902090,52289,1551,기타 ,2010.12
-66271,1389,45,0106903010,67660,6514,갯지렁이,2010.12
-7263,0,0,0106903090,7263,3,기타,2010.12
-49011020,1799043,23379,-,50810063,1084044,-,총계
-72994,0,0,0101101000,72994,4600,말(농가 사육용의 것에 한한다) ,2011.01
-83371,0,0,0101901010,83371,3000,경주말 ,2011.01
-164606,0,0,0101901090,164606,7700,기타 ,2011.01
-7020,0,0,0101909000,7020,5550,기타 ,2011.01
-329325,0,0,0105111000,329325,1159,번식용,2011.01
-216508,0,0,0105191010,216508,2286,번식용의 것 ,2011.01
-1012,0,0,0105191090,1012,64,기타 ,2011.01
-265550,0,0,0106110000,265550,674,영장류,2011.01
-251251,27563,464,0106191000,278814,3355,개,2011.01
-1192,0,0,0106192090,1192,30,기타 ,2011.01
-507744,41034,615,0106199000,548778,4352,기타,2011.01
-35860,0,0,0106201000,35860,403,뱀,2011.01
-54527,0,0,0106202000,54527,5737,자라,2011.01
-69939,0,0,0106203000,69939,4084,거북,2011.01
-17183,0,0,0106209000,17183,39,기타,2011.01
-1460,0,0,0106320000,1460,6,앵무류[패럿류(parrots)ㆍ패러키트류(parakeets)ㆍ금강앵무류ㆍ유황앵무류를 포함한다],2011.01
-12023,0,0,0106901000,12023,1360,양서류,2011.01
-20394,32705,428,0106902090,53099,1055,기타 ,2011.01
-36970,1861,61,0106903010,38831,3659,갯지렁이,2011.01
-107560,0,0,0101101000,107560,3000,말(농가 사육용의 것에 한한다) ,2011.02
-215500,0,0,0101901010,215500,4500,경주말 ,2011.02
-720522,2000,216,0105111000,722522,2362,번식용,2011.02
-330284,0,0,0105191010,330284,3543,번식용의 것 ,2011.02
-188293,33978,822,0106191000,222271,2267,개,2011.02
300,300,6,0106192090,0,0,기타 ,2011.02
-341836,18784,351,0106199000,360620,3036,기타,2011.02
-11877,0,0,0106201000,11877,27,뱀,2011.02
-80437,0,0,0106202000,80437,8646,자라,2011.02
-38996,0,0,0106203000,38996,918,거북,2011.02
-11767,0,0,0106209000,11767,38,기타,2011.02
-1789,0,0,0106320000,1789,24,앵무류[패럿류(parrots)ㆍ패러키트류(parakeets)ㆍ금강앵무류ㆍ유황앵무류를 포함한다],2011.02
-2292,0,0,0106390000,2292,24,기타,2011.02
-6465,0,0,0106901000,6465,37,양서류,2011.02
-31196,39095,516,0106902090,70291,1750,기타 ,2011.02
-63592,1291,41,0106903010,64883,5022,갯지렁이,2011.02
-12384,0,0,0106903090,12384,9,기타,2011.02
-12,0,0,0106909000,12,0,기타,2011.02
-68329,0,0,0101101000,68329,3500,말(농가 사육용의 것에 한한다) ,2011.03
-49600,0,0,0101901010,49600,1350,경주말 ,2011.03
-486147,0,0,0101901090,486147,7000,기타 ,2011.03
-276206,0,0,0105111000,276206,2409,번식용,2011.03
-587761,0,0,0105191010,587761,5727,번식용의 것 ,2011.03
-423659,0,0,0106120000,423659,1111,"고래ㆍ돌고래류(고래목의 포유동물), 바다소(바다소목의 포유동물) ",2011.03
-230461,27412,526,0106191000,257873,2384,개,2011.03
150,150,5,0106192090,0,0,기타 ,2011.03
-575118,26929,459,0106199000,602047,5526,기타,2011.03
-13583,0,0,0106201000,13583,332,뱀,2011.03
-121799,0,0,0106202000,121799,12166,자라,2011.03
-32258,0,0,0106203000,32258,995,거북,2011.03
-29021,0,0,0106209000,29021,30,기타,2011.03
-6098,0,0,0106320000,6098,42,앵무류[패럿류(parrots)ㆍ패러키트류(parakeets)ㆍ금강앵무류ㆍ유황앵무류를 포함한다],2011.03
-11118,0,0,0106390000,11118,81,기타,2011.03
-5052,0,0,0106901000,5052,26,양서류,2011.03
-20837,49318,457,0106902090,70155,1448,기타 ,2011.03
-117899,2039,65,0106903010,119938,9621,갯지렁이,2011.03
-14535,0,0,0106903090,14535,3,기타,2011.03
-18,0,0,0106909000,18,1,기타,2011.03
-313035,18500,450,0101901010,331535,4500,경주말 ,2011.04
-390404,0,0,0101901090,390404,9400,기타 ,2011.04
-296681,0,0,0105111000,296681,2749,번식용,2011.04
-195000,0,0,0105119000,195000,6952,기타,2011.04
-1266422,0,0,0105191010,1266422,11313,번식용의 것 ,2011.04
-455000,0,0,0106110000,455000,1134,영장류,2011.04
-276101,23755,555,0106191000,299856,3716,개,2011.04
-336,0,0,0106192090,336,5,기타 ,2011.04
-693235,26235,469,0106199000,719470,4214,기타,2011.04
-8221,0,0,0106201000,8221,36,뱀,2011.04
-90215,0,0,0106202000,90215,7848,자라,2011.04
-36465,0,0,0106203000,36465,82,거북,2011.04
-27243,0,0,0106209000,27243,85,기타,2011.04
-6460,0,0,0106320000,6460,35,앵무류[패럿류(parrots)ㆍ패러키트류(parakeets)ㆍ금강앵무류ㆍ유황앵무류를 포함한다],2011.04
-6605,0,0,0106390000,6605,37,기타,2011.04
-7569,0,0,0106901000,7569,30,양서류,2011.04
30306,72093,439,0106902090,41787,1570,기타 ,2011.04
-148985,2409,73,0106903010,151394,12200,갯지렁이,2011.04
-900,0,0,0106903020,900,200,실지렁이,2011.04
-11699,0,0,0106903090,11699,361,기타,2011.04
2170,4315,294,0106909000,2145,95,기타,2011.04
-1918374,0,0,0101901010,1918374,24000,경주말 ,2011.05
-123440,0,0,0101901090,123440,3401,기타 ,2011.05
-7601,0,0,0101909000,7601,5850,기타 ,2011.05
-376431,0,0,0105111000,376431,2108,번식용,2011.05
-1177817,0,0,0105191010,1177817,10999,번식용의 것 ,2011.05
-46411,0,0,0105991010,46411,562,번식용,2011.05
-193952,17131,690,0106191000,211083,2575,개,2011.05
-3721,0,0,0106192090,3721,50,기타 ,2011.05
-800,0,0,0106195090,800,30,기타,2011.05
-463091,33266,505,0106199000,496357,3966,기타,2011.05
-12315,0,0,0106201000,12315,31,뱀,2011.05
-143590,0,0,0106202000,143590,13402,자라,2011.05
-28497,0,0,0106203000,28497,177,거북,2011.05
-62948,0,0,0106209000,62948,446,기타,2011.05
-13592,0,0,0106320000,13592,47,앵무류[패럿류(parrots)ㆍ패러키트류(parakeets)ㆍ금강앵무류ㆍ유황앵무류를 포함한다],2011.05
-23701,0,0,0106390000,23701,97,기타,2011.05
10921,29370,570,0106901000,18449,66,양서류,2011.05
16750,59010,363,0106902090,42260,1641,기타 ,2011.05
-288450,3434,100,0106903010,291884,23970,갯지렁이,2011.05
-4605,0,0,0106903090,4605,301,기타,2011.05
-1597,150,5,0106909000,1747,11,기타,2011.05
-124708,0,0,0101101000,124708,1000,말(농가 사육용의 것에 한한다) ,2011.06
-66440,0,0,0101109000,66440,1000,기타 ,2011.06
-2311272,0,0,0101901010,2311272,39700,경주말 ,2011.06
-1194761,0,0,0101901090,1194761,6784,기타 ,2011.06
-29780,0,0,0101909000,29780,5280,기타 ,2011.06
-2075662,0,0,0103100000,2075662,133479,번식용,2011.06
-513101,0,0,0105111000,513101,9113,번식용,2011.06
-406265,0,0,0105119000,406265,9543,기타,2011.06
-1722554,0,0,0105191010,1722554,8389,번식용의 것 ,2011.06
-244200,0,0,0106110000,244200,300,영장류,2011.06
-274407,16682,511,0106191000,291089,3064,개,2011.06
250,250,7,0106192090,0,0,기타 ,2011.06
-535323,24427,443,0106199000,559750,4898,기타,2011.06
-7065,0,0,0106201000,7065,26,뱀,2011.06
-132330,0,0,0106202000,132330,11984,자라,2011.06
-31641,0,0,0106203000,31641,100,거북,2011.06
-26489,0,0,0106209000,26489,58,기타,2011.06
-26094,0,0,0106320000,26094,143,앵무류[패럿류(parrots)ㆍ패러키트류(parakeets)ㆍ금강앵무류ㆍ유황앵무류를 포함한다],2011.06
-21333,19,10,0106390000,21352,99,기타,2011.06
2269,4511,70,0106901000,2242,22,양서류,2011.06
56663,78804,336,0106902090,22141,841,기타 ,2011.06
-374008,7534,220,0106903010,381542,30942,갯지렁이,2011.06
-23730,0,0,0106903090,23730,1121,기타,2011.06
-6455,4205,270,0106909000,10660,115,기타,2011.06
-12691,0,0,0101101000,12691,500,말(농가 사육용의 것에 한한다) ,2011.07
-2594838,0,0,0101901010,2594838,42250,경주말 ,2011.07
-399170,0,0,0101901090,399170,13096,기타 ,2011.07
-15137,0,0,0101909000,15137,4590,기타 ,2011.07
-2662645,0,0,0103100000,2662645,153414,번식용,2011.07
-1228375,0,0,0103910000,1228375,74950,중량이 50킬로그램 미만인 것,2011.07
-903503,0,0,0103920000,903503,94419,중량이 50킬로그램 이상인 것,2011.07
-1254391,0,0,0105111000,1254391,5262,번식용,2011.07
-483225,0,0,0105119000,483225,14116,기타,2011.07
-1684139,0,0,0105191010,1684139,10352,번식용의 것 ,2011.07
-47059,0,0,0105991010,47059,562,번식용,2011.07
-38099,1,1,0106110000,38100,90,영장류,2011.07
-185928,17917,623,0106191000,203845,1959,개,2011.07
-35358,0,0,0106192090,35358,120,기타 ,2011.07
-1300,0,0,0106195090,1300,30,기타,2011.07
-443332,26103,428,0106199000,469435,3875,기타,2011.07
-16981,0,0,0106201000,16981,91,뱀,2011.07
-103048,0,0,0106202000,103048,9292,자라,2011.07
-79158,0,0,0106203000,79158,332,거북,2011.07
-25590,0,0,0106209000,25590,137,기타,2011.07
-25911,0,0,0106320000,25911,95,앵무류[패럿류(parrots)ㆍ패러키트류(parakeets)ㆍ금강앵무류ㆍ유황앵무류를 포함한다],2011.07
-9231,0,0,0106390000,9231,20,기타,2011.07
5385,15220,200,0106901000,9835,25,양서류,2011.07
37824,57266,613,0106902090,19442,546,기타 ,2011.07
-469542,6532,184,0106903010,476074,37700,갯지렁이,2011.07
-24213,0,0,0106903090,24213,806,기타,2011.07
-7201,0,0,0106909000,7201,51,기타,2011.07
-48000,0,0,0101101000,48000,1500,말(농가 사육용의 것에 한한다) ,2011.08
-93000,0,0,0101901010,93000,1500,경주말 ,2011.08
-49516,0,0,0101901090,49516,8150,기타 ,2011.08
-1832804,0,0,0103100000,1832804,91405,번식용,2011.08
-1565735,0,0,0103910000,1565735,88306,중량이 50킬로그램 미만인 것,2011.08
-978289,0,0,0103920000,978289,68071,중량이 50킬로그램 이상인 것,2011.08
-2443965,22844,134,0105111000,2466809,16677,번식용,2011.08
-182922,0,0,0105119000,182922,5910,기타,2011.08
-186019,0,0,0105191010,186019,2290,번식용의 것 ,2011.08
-106081,0,0,0105991010,106081,1258,번식용,2011.08
-260000,0,0,0106110000,260000,310,영장류,2011.08
-211864,20272,493,0106191000,232136,2676,개,2011.08
-10661,0,0,0106192090,10661,70,기타 ,2011.08
28481,28481,250,0106194000,0,0,곰,2011.08
-1600,0,0,0106195090,1600,30,기타,2011.08
-685750,31519,505,0106199000,717269,5129,기타,2011.08
-3352,0,0,0106201000,3352,6,뱀,2011.08
-101637,0,0,0106202000,101637,9041,자라,2011.08
-67973,0,0,0106203000,67973,192,거북,2011.08
-18156,0,0,0106209000,18156,29,기타,2011.08
-6726,0,0,0106320000,6726,30,앵무류[패럿류(parrots)ㆍ패러키트류(parakeets)ㆍ금강앵무류ㆍ유황앵무류를 포함한다],2011.08
-3116,0,0,0106901000,3116,25,양서류,2011.08
34484,80119,492,0106902090,45635,1033,기타 ,2011.08
-594637,3507,133,0106903010,598144,47138,갯지렁이,2011.08
-111,0,0,0106903020,111,33,실지렁이,2011.08
-7854,0,0,0106903090,7854,5,기타,2011.08
-10469,0,0,0106909000,10469,121,기타,2011.08
-58481,0,0,0101109000,58481,500,기타 ,2011.09
-307461,0,0,0101901010,307461,3222,경주말 ,2011.09
20178,20178,1500,0101901090,0,0,기타 ,2011.09
-7200,0,0,0101909000,7200,6000,기타 ,2011.09
-875000,0,0,0102101000,875000,5474,젖소 ,2011.09
-655869,0,0,0103100000,655869,37365,번식용,2011.09
-252696,0,0,0103910000,252696,18950,중량이 50킬로그램 미만인 것,2011.09
-1013751,0,0,0103920000,1013751,85665,중량이 50킬로그램 이상인 것,2011.09
-402910,0,0,0105111000,402910,2791,번식용,2011.09
-381298,0,0,0105119000,381298,4246,기타,2011.09
-350938,0,0,0105191010,350938,3402,번식용의 것 ,2011.09
-18000,0,0,0106110000,18000,20,영장류,2011.09
-199061,28915,589,0106191000,227976,2400,개,2011.09
-602,98,15,0106192090,700,19,기타 ,2011.09
-84000,0,0,0106194000,84000,500,곰,2011.09
-559520,42127,690,0106199000,601647,4552,기타,2011.09
-21298,2604,1,0106201000,23902,549,뱀,2011.09
-79191,0,0,0106202000,79191,6981,자라,2011.09
-81691,0,0,0106203000,81691,204,거북,2011.09
-50074,0,0,0106209000,50074,150,기타,2011.09
-950,0,0,0106320000,950,2,앵무류[패럿류(parrots)ㆍ패러키트류(parakeets)ㆍ금강앵무류ㆍ유황앵무류를 포함한다],2011.09
-8625,0,0,0106390000,8625,50,기타,2011.09
-10307,0,0,0106901000,10307,74,양서류,2011.09
34923,103859,765,0106902090,68936,1645,기타 ,2011.09
-603982,1468,90,0106903010,605450,49252,갯지렁이,2011.09
-35,0,0,0106903020,35,10,실지렁이,2011.09
-23680,0,0,0106909000,23680,230,기타,2011.09
-93843,0,0,0101101000,93843,4400,말(농가 사육용의 것에 한한다) ,2011.10
-617326,0,0,0101901010,617326,11500,경주말 ,2011.10
-112237,0,0,0101901090,112237,3000,기타 ,2011.10
-37314,0,0,0101909000,37314,6480,기타 ,2011.10
-1108873,0,0,0103100000,1108873,63736,번식용,2011.10
-787774,0,0,0103910000,787774,55680,중량이 50킬로그램 미만인 것,2011.10
-215867,0,0,0103920000,215867,15550,중량이 50킬로그램 이상인 것,2011.10
-1093366,0,0,0105111000,1093366,4597,번식용,2011.10
-122363,0,0,0105119000,122363,4603,기타,2011.10
-408347,0,0,0105191010,408347,3988,번식용의 것 ,2011.10
-22049,0,0,0105991010,22049,283,번식용,2011.10
-154488,0,0,0106110000,154488,307,영장류,2011.10
-202953,19609,543,0106191000,222562,2990,개,2011.10
-27941,279,17,0106192090,28220,131,기타 ,2011.10
-488568,31956,435,0106199000,520524,4156,기타,2011.10
-10205,0,0,0106201000,10205,1015,뱀,2011.10
-104307,0,0,0106202000,104307,9602,자라,2011.10
-58938,0,0,0106203000,58938,343,거북,2011.10
-22453,0,0,0106209000,22453,53,기타,2011.10
-22780,0,0,0106320000,22780,96,앵무류[패럿류(parrots)ㆍ패러키트류(parakeets)ㆍ금강앵무류ㆍ유황앵무류를 포함한다],2011.10
-920,3055,65,0106901000,3975,20,양서류,2011.10
17711,59668,204,0106902090,41957,760,기타 ,2011.10
-503111,993,74,0106903010,504104,41490,갯지렁이,2011.10
-13541,0,0,0106903090,13541,6,기타,2011.10
-10549,0,0,0106909000,10549,90,기타,2011.10
-113624,0,0,0101101000,113624,4500,말(농가 사육용의 것에 한한다) ,2011.11
-10445,0,0,0101109000,10445,5550,기타 ,2011.11
-224984,187617,1700,0101901010,412601,7500,경주말 ,2011.11
-3144005,0,0,0103100000,3144005,198680,번식용,2011.11
-106097,0,0,0103920000,106097,4250,중량이 50킬로그램 이상인 것,2011.11
-247938,0,0,0105111000,247938,2369,번식용,2011.11
-52990,0,0,0105119000,52990,921,기타,2011.11
-666141,0,0,0105191010,666141,3937,번식용의 것 ,2011.11
-15100,0,0,0106110000,15100,17,영장류,2011.11
-225121,20107,674,0106191000,245228,2712,개,2011.11
253,453,27,0106192090,200,2,기타 ,2011.11
-463408,25770,353,0106199000,489178,6529,기타,2011.11
-20657,0,0,0106201000,20657,567,뱀,2011.11
-83205,0,0,0106202000,83205,7435,자라,2011.11
-47813,0,0,0106203000,47813,134,거북,2011.11
-28464,0,0,0106209000,28464,81,기타,2011.11
-21443,0,0,0106320000,21443,60,앵무류[패럿류(parrots)ㆍ패러키트류(parakeets)ㆍ금강앵무류ㆍ유황앵무류를 포함한다],2011.11
-15898,0,0,0106390000,15898,70,기타,2011.11
-10011,1896,30,0106901000,11907,51,양서류,2011.11
5278,53809,300,0106902090,48531,1136,기타 ,2011.11
-296377,647,54,0106903010,297024,24936,갯지렁이,2011.11
-3180,0,0,0106903090,3180,2,기타,2011.11
-11542,0,0,0106909000,11542,190,기타,2011.11
-2400534,0,0,0101101000,2400534,53200,말(농가 사육용의 것에 한한다) ,2011.12
-74845,0,0,0101109000,74845,2900,기타 ,2011.12
-517776,0,0,0101901010,517776,10500,경주말 ,2011.12
-249290,0,0,0101901090,249290,1200,기타 ,2011.12
-437763,0,0,0103100000,437763,30118,번식용,2011.12
-11305,0,0,0103910000,11305,850,중량이 50킬로그램 미만인 것,2011.12
-531384,0,0,0103920000,531384,52905,중량이 50킬로그램 이상인 것,2011.12
-1153206,0,0,0105111000,1153206,5724,번식용,2011.12
-1034806,0,0,0105191010,1034806,6602,번식용의 것 ,2011.12
-38258,0,0,0105991010,38258,359,번식용,2011.12
-170000,0,0,0106120000,170000,380,"고래ㆍ돌고래류(고래목의 포유동물), 바다소(바다소목의 포유동물) ",2011.12
-181520,30872,591,0106191000,212392,2119,개,2011.12
-9996,456,42,0106192090,10452,12,기타 ,2011.12
-511683,34788,586,0106199000,546471,4139,기타,2011.12
-989,300,1,0106201000,1289,5,뱀,2011.12
-56100,0,0,0106202000,56100,4889,자라,2011.12
-50382,0,0,0106203000,50382,441,거북,2011.12
-22723,0,0,0106209000,22723,27,기타,2011.12
-39944,0,0,0106320000,39944,141,앵무류[패럿류(parrots)ㆍ패러키트류(parakeets)ㆍ금강앵무류ㆍ유황앵무류를 포함한다],2011.12
-13791,0,0,0106390000,13791,25,기타,2011.12
-11840,0,0,0106901000,11840,2002,양서류,2011.12
-28764,9329,112,0106902090,38093,798,기타 ,2011.12
-92686,92,38,0106903010,92778,7616,갯지렁이,2011.12
-18694,0,0,0106903090,18694,7,기타,2011.12
-4230,0,0,0106909000,4230,22,기타,2011.12
-74326048,1721285,24962,-,76047333,2313715,-,총계
-768865,0,0,0101211000,768865,16600,농가 사육용,2012.01
-54760,0,0,0101309000,54760,8850,기타,2012.01
-177192,0,0,0103100000,177192,8150,번식용,2012.01
-738985,0,0,0103910000,738985,38066,중량이 50킬로그램 미만인 것,2012.01
-847365,0,0,0103920000,847365,53695,중량이 50킬로그램 이상인 것,2012.01
-1138743,0,0,0105111000,1138743,4927,번식용,2012.01
-18266,0,0,0105119000,18266,2833,기타,2012.01
-239800,0,0,0105131000,239800,2657,번식용,2012.01
-305,0,0,0106149000,305,1,기타,2012.01
-136986,25859,527,0106191000,162845,1661,개,2012.01
-441287,33886,578,0106199000,475173,3331,기타,2012.01
-1010,2174,2,0106201000,3184,12,뱀,2012.01
-68045,0,0,0106202000,68045,6494,자라,2012.01
-21520,0,0,0106203000,21520,1443,거북,2012.01
-15547,0,0,0106209000,15547,27,기타,2012.01
-4849,0,0,0106320000,4849,10,앵무류[패럿류(parrots)ㆍ패러키트류(parakeets)ㆍ금강앵무류ㆍ유황앵무류를 포함한다],2012.01
-3000,0,0,0106390000,3000,20,기타,2012.01
-32884,0,0,0106419000,32884,1030,기타,2012.01
-4125,15607,169,0106490000,19732,183,기타,2012.01
-4773,0,0,0106901000,4773,26,양서류,2012.01
-69046,314,44,0106903010,69360,5550,갯지렁이,2012.01
-22956,0,0,0106909000,22956,30,기타,2012.01
-312605,0,0,0101211000,312605,5000,농가 사육용,2012.02
-2223972,0,0,0101219000,2223972,1200,기타,2012.02
-211971,0,0,0101291000,211971,4850,경주말,2012.02
-66788,0,0,0101299000,66788,1600,기타,2012.02
-82578,0,0,0103100000,82578,4514,번식용,2012.02
-218867,0,0,0103910000,218867,15484,중량이 50킬로그램 미만인 것,2012.02
-1377962,2818,159,0105111000,1380780,8051,번식용,2012.02
-192116,0,0,0105131000,192116,1878,번식용,2012.02
-3000,0,0,0106110000,3000,5,영장류,2012.02
-18676,0,0,0106141000,18676,90,번식용,2012.02
50,50,1,0106149000,0,0,기타,2012.02
-170555,34412,1408,0106191000,204967,2432,개,2012.02
-100,0,0,0106195090,100,14,기타,2012.02
-511267,21696,341,0106199000,532963,3233,기타,2012.02
-17572,0,0,0106201000,17572,44,뱀,2012.02
-89512,0,0,0106202000,89512,8533,자라,2012.02
-64117,0,0,0106203000,64117,509,거북,2012.02
-21903,0,0,0106209000,21903,50,기타,2012.02
-14045,0,0,0106310000,14045,23,맹금류,2012.02
-31818,0,0,0106320000,31818,114,앵무류[패럿류(parrots)ㆍ패러키트류(parakeets)ㆍ금강앵무류ㆍ유황앵무류를 포함한다],2012.02
-61920,0,0,0106390000,61920,72,기타,2012.02
-27781,0,0,0106419000,27781,805,기타,2012.02
-2355,23244,104,0106490000,25599,364,기타,2012.02
-9448,0,0,0106901000,9448,46,양서류,2012.02
-52921,1235,80,0106903010,54156,4550,갯지렁이,2012.02
-416,0,0,0106903020,416,14,실지렁이,2012.02
-5247,0,0,0106909000,5247,46,기타,2012.02
-1832540,0,0,0101291000,1832540,24980,경주말,2012.03
-302782,0,0,0101299000,302782,19700,기타,2012.03
-1328917,0,0,0103100000,1328917,82345,번식용,2012.03
-475225,0,0,0103910000,475225,32509,중량이 50킬로그램 미만인 것,2012.03
-50011,0,0,0103920000,50011,3410,중량이 50킬로그램 이상인 것,2012.03
-75234,0,0,0105131000,75234,727,번식용,2012.03
-154421,0,0,0106121000,154421,350,"고래ㆍ돌고래ㆍ쇠돌고래(고래목의 포유동물), 매너티ㆍ듀공(바다소목의 포유동물)",2012.03
-431,100,5,0106149000,531,25,기타,2012.03
-290761,25182,699,0106191000,315943,3403,개,2012.03
-665628,34749,621,0106199000,700377,3828,기타,2012.03
-15212,0,0,0106201000,15212,44,뱀,2012.03
-88844,0,0,0106202000,88844,7936,자라,2012.03
-83750,0,0,0106203000,83750,688,거북,2012.03
-15674,0,0,0106209000,15674,69,기타,2012.03
-7861,0,0,0106320000,7861,19,앵무류[패럿류(parrots)ㆍ패러키트류(parakeets)ㆍ금강앵무류ㆍ유황앵무류를 포함한다],2012.03
-51952,0,0,0106419000,51952,1930,기타,2012.03
15414,41310,128,0106490000,25896,246,기타,2012.03
-9713,0,0,0106901000,9713,60,양서류,2012.03
-90665,1232,52,0106903010,91897,7698,갯지렁이,2012.03
-6624,0,0,0106903090,6624,4,기타,2012.03
4981,6122,355,0106909000,1141,62,기타,2012.03
-954152,0,0,0101291000,954152,11550,경주말,2012.04
-191827,0,0,0101299000,191827,6800,기타,2012.04
-57167,0,0,0101309000,57167,10710,기타,2012.04
-1822225,0,0,0103100000,1822225,88354,번식용,2012.04
-1075047,0,0,0103910000,1075047,74275,중량이 50킬로그램 미만인 것,2012.04
-102083,0,0,0105111000,102083,1144,번식용,2012.04
-466992,0,0,0105131000,466992,3012,번식용,2012.04
-42000,0,0,0106110000,42000,68,영장류,2012.04
-270454,18226,851,0106191000,288680,3630,개,2012.04
-1200,0,0,0106195090,1200,50,기타,2012.04
-596442,37467,572,0106199000,633909,3883,기타,2012.04
-12873,0,0,0106201000,12873,103,뱀,2012.04
-131667,0,0,0106202000,131667,9937,자라,2012.04
-56035,0,0,0106203000,56035,610,거북,2012.04
-40512,0,0,0106209000,40512,1666,기타,2012.04
-1994,0,0,0106390000,1994,20,기타,2012.04
-102461,0,0,0106419000,102461,6743,기타,2012.04
46464,64886,271,0106490000,18422,191,기타,2012.04
3246,12532,235,0106901000,9286,44,양서류,2012.04
-203810,1293,53,0106903010,205103,16549,갯지렁이,2012.04
-7433,0,0,0106903090,7433,151,기타,2012.04
48,60,1,0106909000,12,0,기타,2012.04
-624172,0,0,0101291000,624172,8250,경주말,2012.05
-308000,0,0,0101299000,308000,600,기타,2012.05
-1026690,0,0,0103100000,1026690,21274,번식용,2012.05
-48375,0,0,0103920000,48375,5940,중량이 50킬로그램 이상인 것,2012.05
-578953,0,0,0105111000,578953,3166,번식용,2012.05
-91813,0,0,0105119000,91813,2885,기타,2012.05
-501452,0,0,0105131000,501452,4716,번식용,2012.05
-316800,0,0,0106110000,316800,771,영장류,2012.05
-10000,0,0,0106122000,10000,60,"물개, 바다사자와 바다코끼리(기각아목의 포유동물)",2012.05
-153234,47305,971,0106191000,200539,2747,개,2012.05
-2000,0,0,0106195090,2000,40,기타,2012.05
-578684,27841,441,0106199000,606525,3564,기타,2012.05
-8789,0,0,0106201000,8789,19,뱀,2012.05
-100246,0,0,0106202000,100246,8254,자라,2012.05
-71152,0,0,0106203000,71152,150,거북,2012.05
-54162,0,0,0106209000,54162,155,기타,2012.05
-44682,0,0,0106320000,44682,139,앵무류[패럿류(parrots)ㆍ패러키트류(parakeets)ㆍ금강앵무류ㆍ유황앵무류를 포함한다],2012.05
-25623,30,25,0106390000,25653,104,기타,2012.05
-101548,0,0,0106419000,101548,5750,기타,2012.05
85482,95324,463,0106490000,9842,135,기타,2012.05
465,10790,265,0106901000,10325,55,양서류,2012.05
-529351,4925,145,0106903010,534276,42789,갯지렁이,2012.05
-26,0,0,0106903020,26,2,실지렁이,2012.05
-7265,0,0,0106903090,7265,9,기타,2012.05
-1233,0,0,0106909000,1233,110,기타,2012.05
-2520172,0,0,0101291000,2520172,37550,경주말,2012.06
-259183,0,0,0101299000,259183,7587,기타,2012.06
-983284,0,0,0103100000,983284,47145,번식용,2012.06
-425039,0,0,0103910000,425039,22550,중량이 50킬로그램 미만인 것,2012.06
-449428,0,0,0105111000,449428,1687,번식용,2012.06
-241827,0,0,0105131000,241827,2390,번식용,2012.06
-101382,0,0,0106121000,101382,175,"고래ㆍ돌고래ㆍ쇠돌고래(고래목의 포유동물), 매너티ㆍ듀공(바다소목의 포유동물)",2012.06
-61011,0,0,0106122000,61011,242,"물개, 바다사자와 바다코끼리(기각아목의 포유동물)",2012.06
-6701,0,0,0106149000,6701,50,기타,2012.06
-133809,24528,739,0106191000,158337,1954,개,2012.06
-2000,0,0,0106195090,2000,30,기타,2012.06
-603726,42117,836,0106199000,645843,4205,기타,2012.06
-15064,210,2,0106201000,15274,101,뱀,2012.06
-108497,0,0,0106202000,108497,8759,자라,2012.06
-86210,0,0,0106203000,86210,231,거북,2012.06
-27281,0,0,0106209000,27281,117,기타,2012.06
-7698,0,0,0106320000,7698,50,앵무류[패럿류(parrots)ㆍ패러키트류(parakeets)ㆍ금강앵무류ㆍ유황앵무류를 포함한다],2012.06
-33390,0,0,0106419000,33390,2568,기타,2012.06
62945,68536,519,0106490000,5591,121,기타,2012.06
-9332,0,0,0106901000,9332,53,양서류,2012.06
-435686,5470,158,0106903010,441156,35266,갯지렁이,2012.06
-14017,0,0,0106903090,14017,6,기타,2012.06
4977,5816,360,0106909000,839,29,기타,2012.06
-2495094,0,0,0101291000,2495094,45050,경주말,2012.07
-178240,0,0,0101299000,178240,7450,기타,2012.07
-72988,0,0,0101309000,72988,19275,기타,2012.07
-1072373,0,0,0103100000,1072373,42840,번식용,2012.07
-471866,0,0,0103910000,471866,26150,중량이 50킬로그램 미만인 것,2012.07
-735850,0,0,0105111000,735850,2860,번식용,2012.07
-197561,0,0,0105131000,197561,1863,번식용,2012.07
-423000,0,0,0106110000,423000,489,영장류,2012.07
-572,200,6,0106149000,772,25,기타,2012.07
-73265,29551,864,0106191000,102816,1350,개,2012.07
-641671,28378,451,0106199000,670049,4407,기타,2012.07
-3063,0,0,0106201000,3063,9,뱀,2012.07
-86360,0,0,0106202000,86360,7157,자라,2012.07
-106608,89,1,0106203000,106697,285,거북,2012.07
-35116,0,0,0106209000,35116,50,기타,2012.07
-74868,0,0,0106320000,74868,222,앵무류[패럿류(parrots)ㆍ패러키트류(parakeets)ㆍ금강앵무류ㆍ유황앵무류를 포함한다],2012.07
-12719,0,0,0106390000,12719,13,기타,2012.07
-23716,0,0,0106419000,23716,2114,기타,2012.07
46223,63355,349,0106490000,17132,313,기타,2012.07
-4482,0,0,0106901000,4482,27,양서류,2012.07
-493293,10395,156,0106903010,503688,40165,갯지렁이,2012.07
-13732,0,0,0106903090,13732,6,기타,2012.07
-9145,0,0,0106909000,9145,107,기타,2012.07
-147881,0,0,0101291000,147881,5200,경주말,2012.08
-371368,0,0,0101299000,371368,17650,기타,2012.08
-129283,0,0,0103100000,129283,3750,번식용,2012.08
-372997,0,0,0103910000,372997,19000,중량이 50킬로그램 미만인 것,2012.08
-1947624,0,0,0105111000,1947624,6986,번식용,2012.08
-142221,0,0,0105131000,142221,1334,번식용,2012.08
-17100,0,0,0106110000,17100,18,영장류,2012.08
-214,0,0,0106149000,214,2,기타,2012.08
-131218,29843,544,0106191000,161061,2087,개,2012.08
-405,0,0,0106195090,405,7,기타,2012.08
-575510,28657,470,0106199000,604167,4548,기타,2012.08
-2431,0,0,0106201000,2431,7,뱀,2012.08
-92820,0,0,0106202000,92820,7516,자라,2012.08
-89290,1010,0,0106203000,90300,242,거북,2012.08
-31240,0,0,0106209000,31240,86,기타,2012.08
-24193,0,0,0106320000,24193,114,앵무류[패럿류(parrots)ㆍ패러키트류(parakeets)ㆍ금강앵무류ㆍ유황앵무류를 포함한다],2012.08
-69567,0,0,0106390000,69567,330,기타,2012.08
-26140,0,0,0106419000,26140,2062,기타,2012.08
50995,64836,369,0106490000,13841,216,기타,2012.08
-3350,0,0,0106901000,3350,30,양서류,2012.08
-424566,33258,367,0106903010,457824,37204,갯지렁이,2012.08
-11072,0,0,0106903090,11072,7,기타,2012.08
-10215,0,0,0106909000,10215,43,기타,2012.08
-132215,0,0,0101299000,132215,1500,기타,2012.09
-884000,0,0,0102211000,884000,3915,젖소,2012.09
-796478,0,0,0103100000,796478,34845,번식용,2012.09
-526561,0,0,0105111000,526561,2736,번식용,2012.09
-118342,0,0,0105119000,118342,526,기타,2012.09
-135330,0,0,0105131000,135330,1286,번식용,2012.09
-248346,0,0,0105991010,248346,265,번식용,2012.09
-36000,0,0,0106110000,36000,38,영장류,2012.09
-309,0,0,0106149000,309,2,기타,2012.09
-112141,37583,791,0106191000,149724,1966,개,2012.09
14056,14056,340,0106194000,0,0,곰,2012.09
-605857,43641,903,0106199000,649498,4824,기타,2012.09
-25312,0,0,0106201000,25312,564,뱀,2012.09
-62398,0,0,0106202000,62398,5071,자라,2012.09
-68222,0,0,0106203000,68222,348,거북,2012.09
-35396,0,0,0106209000,35396,61,기타,2012.09
-35623,0,0,0106320000,35623,160,앵무류[패럿류(parrots)ㆍ패러키트류(parakeets)ㆍ금강앵무류ㆍ유황앵무류를 포함한다],2012.09
-17096,0,0,0106390000,17096,100,기타,2012.09
-32886,0,0,0106419000,32886,811,기타,2012.09
39287,74192,260,0106490000,34905,575,기타,2012.09
-6113,0,0,0106901000,6113,54,양서류,2012.09
-586433,7022,119,0106903010,593455,48446,갯지렁이,2012.09
-2871,0,0,0106903090,2871,2,기타,2012.09
-10764,1548,18,0106909000,12312,144,기타,2012.09
-91000,0,0,0101291000,91000,800,경주말,2012.10
-175596,0,0,0101299000,175596,5890,기타,2012.10
-570557,0,0,0103100000,570557,42325,번식용,2012.10
-972184,0,0,0105111000,972184,1822,번식용,2012.10
-72240,0,0,0105131000,72240,686,번식용,2012.10
-250441,0,0,0105991010,250441,265,번식용,2012.10
-663420,0,0,0106110000,663420,795,영장류,2012.10
-121810,48485,772,0106191000,170295,2047,개,2012.10
-3000,0,0,0106195010,3000,171,번식용,2012.10
-586005,40563,607,0106199000,626568,4094,기타,2012.10
-11475,0,0,0106201000,11475,612,뱀,2012.10
-75405,0,0,0106202000,75405,5902,자라,2012.10
-48009,0,0,0106203000,48009,135,거북,2012.10
-18528,0,0,0106209000,18528,37,기타,2012.10
-27419,0,0,0106320000,27419,110,앵무류[패럿류(parrots)ㆍ패러키트류(parakeets)ㆍ금강앵무류ㆍ유황앵무류를 포함한다],2012.10
-23923,0,0,0106390000,23923,75,기타,2012.10
-49229,0,0,0106419000,49229,921,기타,2012.10
6785,50271,206,0106490000,43486,918,기타,2012.10
-4256,0,0,0106901000,4256,31,양서류,2012.10
-597356,2695,74,0106903010,600051,49166,갯지렁이,2012.10
-12,0,0,0106903020,12,61,실지렁이,2012.10
-6984,0,0,0106903090,6984,1,기타,2012.10
-11521,518,6,0106909000,12039,42,기타,2012.10
-167058,0,0,0101211000,167058,4500,농가 사육용,2012.11
-500771,0,0,0101291000,500771,9250,경주말,2012.11
-39950,0,0,0101299000,39950,1200,기타,2012.11
-30931,0,0,0101309000,30931,7150,기타,2012.11
-216101,0,0,0101900000,216101,1500,기타,2012.11
-57494,0,0,0103100000,57494,4360,번식용,2012.11
-674139,0,0,0105111000,674139,3294,번식용,2012.11
-31504,0,0,0105131000,31504,292,번식용,2012.11
-28000,0,0,0106110000,28000,50,영장류,2012.11
-119911,44197,577,0106191000,164108,2891,개,2012.11
-1043397,32339,600,0106199000,1075736,8168,기타,2012.11
-19954,663,11,0106201000,20617,922,뱀,2012.11
-117015,0,0,0106202000,117015,9651,자라,2012.11
-79880,1637,2,0106203000,81517,601,거북,2012.11
-44934,0,0,0106209000,44934,165,기타,2012.11
-41814,0,0,0106320000,41814,130,앵무류[패럿류(parrots)ㆍ패러키트류(parakeets)ㆍ금강앵무류ㆍ유황앵무류를 포함한다],2012.11
-6939,0,0,0106390000,6939,35,기타,2012.11
-37092,0,0,0106419000,37092,978,기타,2012.11
-1046,17462,157,0106490000,18508,350,기타,2012.11
-16502,0,0,0106901000,16502,49,양서류,2012.11
-240047,9651,178,0106903010,249698,20299,갯지렁이,2012.11
-15691,0,0,0106903090,15691,8,기타,2012.11
-15399,3023,36,0106909000,18422,56,기타,2012.11
-2502921,0,0,0101211000,2502921,50720,농가 사육용,2012.12
-91013,0,0,0101219000,91013,1840,기타,2012.12
-1194962,0,0,0101291000,1194962,15140,경주말,2012.12
-91847,0,0,0101299000,91847,5375,기타,2012.12
-4500,0,0,0101900000,4500,300,기타,2012.12
-150981,0,0,0103100000,150981,5955,번식용,2012.12
-450805,0,0,0105111000,450805,1823,번식용,2012.12
-53082,0,0,0105131000,53082,497,번식용,2012.12
-504773,0,0,0105991010,504773,530,번식용,2012.12
100,100,2,0106149000,0,0,기타,2012.12
-85988,41013,443,0106191000,127001,1181,개,2012.12
-783898,23832,370,0106199000,807730,6798,기타,2012.12
-25442,0,0,0106201000,25442,176,뱀,2012.12
-55666,0,0,0106202000,55666,4730,자라,2012.12
-56085,0,0,0106203000,56085,710,거북,2012.12
-40729,0,0,0106209000,40729,63,기타,2012.12
-151216,0,0,0106320000,151216,357,앵무류[패럿류(parrots)ㆍ패러키트류(parakeets)ㆍ금강앵무류ㆍ유황앵무류를 포함한다],2012.12
-18887,0,0,0106390000,18887,155,기타,2012.12
-33183,0,0,0106419000,33183,1364,기타,2012.12
6383,13566,203,0106490000,7183,103,기타,2012.12
-10341,0,0,0106901000,10341,47,양서류,2012.12
-61124,3684,64,0106903010,64808,5182,갯지렁이,2012.12
-4212,0,0,0106903090,4212,3,기타,2012.12
-9567,493,6,0106909000,10060,105,기타,2012.12
-64235667,1539152,22499,-,65774819,1648054,-,총계
-703891,0,0,0101211000,703891,3800,농가 사육용,2013.01
-2001785,0,0,0101219000,2001785,2000,기타,2013.01
-1271450,16488,272,0105111000,1287938,4547,번식용,2013.01
-198111,0,0,0105991010,198111,254,번식용,2013.01
-308700,0,0,0106110000,308700,360,영장류,2013.01
-73711,74345,750,0106191000,148056,1672,개,2013.01
-570054,36707,569,0106199000,606761,3553,기타,2013.01
-12206,1500,10,0106201000,13706,53,뱀,2013.01
-68188,0,0,0106202000,68188,5816,자라,2013.01
-57952,0,0,0106203000,57952,945,거북,2013.01
-59015,0,0,0106209000,59015,179,기타,2013.01
-22000,0,0,0106320000,22000,10,앵무류[패럿류(parrots)ㆍ패러키트류(parakeets)ㆍ금강앵무류ㆍ유황앵무류를 포함한다],2013.01
-62146,0,0,0106419000,62146,3471,기타,2013.01
-1637,19726,208,0106490000,21363,268,기타,2013.01
-5975,3500,50,0106901000,9475,582,양서류,2013.01
-64955,1515,42,0106903010,66470,5364,갯지렁이,2013.01
-7132,0,0,0106903090,7132,1,기타,2013.01
-10244,0,0,0106909000,10244,31,기타,2013.01
-92914,0,0,0101211000,92914,2000,농가 사육용,2013.02
-1423182,0,0,0101291000,1423182,17530,경주말,2013.02
-338211,0,0,0101299000,338211,2700,기타,2013.02
-409934,0,0,0105111000,409934,2138,번식용,2013.02
-24082,0,0,0106110000,24082,641,영장류,2013.02
-910,0,0,0106149000,910,6,기타,2013.02
-118281,36689,753,0106191000,154970,1997,개,2013.02
-528649,29445,550,0106199000,558094,3368,기타,2013.02
-7072,0,0,0106201000,7072,4,뱀,2013.02
-49253,0,0,0106202000,49253,4529,자라,2013.02
-31852,0,0,0106203000,31852,1952,거북,2013.02
-18789,0,0,0106209000,18789,39,기타,2013.02
-38021,0,0,0106320000,38021,170,앵무류[패럿류(parrots)ㆍ패러키트류(parakeets)ㆍ금강앵무류ㆍ유황앵무류를 포함한다],2013.02
-2864,0,0,0106390000,2864,54,기타,2013.02
-67599,0,0,0106419000,67599,1909,기타,2013.02
-3000,32954,190,0106490000,35954,359,기타,2013.02
-8653,0,0,0106901000,8653,40,양서류,2013.02
-76633,1826,51,0106903010,78459,6286,갯지렁이,2013.02
-5671,0,0,0106903090,5671,66,기타,2013.02
-14699,0,0,0106909000,14699,36,기타,2013.02
-1703216,0,0,0101291000,1703216,23900,경주말,2013.03
-144001,0,0,0101299000,144001,12320,기타,2013.03
-38392,0,0,0101309000,38392,9030,기타,2013.03
-1240051,0,0,0103100000,1240051,51075,번식용,2013.03
-293398,0,0,0105119000,293398,1062,기타,2013.03
100,100,2,0106149000,0,0,기타,2013.03
-103248,30393,567,0106191000,133641,1865,개,2013.03
-583509,26372,460,0106199000,609881,3072,기타,2013.03
-7927,0,0,0106201000,7927,30,뱀,2013.03
-97767,0,0,0106202000,97767,7720,자라,2013.03
-95917,0,0,0106203000,95917,683,거북,2013.03
-47367,0,0,0106209000,47367,180,기타,2013.03
-39145,0,0,0106320000,39145,60,앵무류[패럿류(parrots)ㆍ패러키트류(parakeets)ㆍ금강앵무류ㆍ유황앵무류를 포함한다],2013.03
-55564,0,0,0106390000,55564,147,기타,2013.03
-82946,0,0,0106419000,82946,3107,기타,2013.03
15687,47556,156,0106490000,31869,542,기타,2013.03
-6785,0,0,0106901000,6785,26,양서류,2013.03
-157600,1844,53,0106903010,159444,13174,갯지렁이,2013.03
-13274,0,0,0106903090,13274,8,기타,2013.03
-13520,0,0,0106909000,13520,54,기타,2013.03
-539201,0,0,0101291000,539201,11306,경주말,2013.04
-326942,0,0,0101299000,326942,1200,기타,2013.04
-328543,0,0,0103100000,328543,22040,번식용,2013.04
-70507,0,0,0105111000,70507,759,번식용,2013.04
-192297,0,0,0106110000,192297,45,영장류,2013.04
-122266,26913,827,0106191000,149179,1607,개,2013.04
-521202,36542,644,0106199000,557744,3451,기타,2013.04
-28792,0,0,0106201000,28792,65,뱀,2013.04
-118125,0,0,0106202000,118125,10523,자라,2013.04
-59996,0,0,0106203000,59996,811,거북,2013.04
-30625,0,0,0106209000,30625,86,기타,2013.04
-64126,0,0,0106320000,64126,204,앵무류[패럿류(parrots)ㆍ패러키트류(parakeets)ㆍ금강앵무류ㆍ유황앵무류를 포함한다],2013.04
-65254,0,0,0106419000,65254,3260,기타,2013.04
83284,103417,258,0106490000,20133,423,기타,2013.04
-4141,0,0,0106901000,4141,25,양서류,2013.04
-210968,3075,89,0106903010,214043,15903,갯지렁이,2013.04
-2218,0,0,0106903020,2218,942,실지렁이,2013.04
-7151,0,0,0106903090,7151,2,기타,2013.04
-5284,3385,300,0106909000,8669,117,기타,2013.04
-27158,0,0,0101211000,27158,2,농가 사육용,2013.05
-3107330,26400,1500,0101291000,3133730,42500,경주말,2013.05
-62126,0,0,0101299000,62126,2400,기타,2013.05
-27060,0,0,0101309000,27060,5400,기타,2013.05
-241756,0,0,0105111000,241756,1356,번식용,2013.05
-97494,0,0,0105119000,97494,2888,기타,2013.05
-152435,0,0,0105131000,152435,244,번식용,2013.05
-467,0,0,0105992000,467,21,칠면조,2013.05
-503,0,0,0105999000,503,15,기타,2013.05
-16000,0,0,0106110000,16000,96,영장류,2013.05
-122844,34127,971,0106191000,156971,1689,개,2013.05
-624115,33734,1009,0106199000,657849,4579,기타,2013.05
-20272,0,0,0106201000,20272,62,뱀,2013.05
-60749,0,0,0106202000,60749,5267,자라,2013.05
-39638,0,0,0106203000,39638,413,거북,2013.05
-75679,0,0,0106209000,75679,166,기타,2013.05
-37980,0,0,0106419000,37980,1700,기타,2013.05
103808,113980,377,0106490000,10172,197,기타,2013.05
14996,23523,379,0106901000,8527,45,양서류,2013.05
-476098,8180,185,0106903010,484278,33607,갯지렁이,2013.05
-504,0,0,0106903020,504,260,실지렁이,2013.05
-503,0,0,0106903090,503,3,기타,2013.05
-1363,0,0,0106909000,1363,5,기타,2013.05
-2117101,0,0,0101291000,2117101,28180,경주말,2013.06
-23253,0,0,0101299000,23253,1100,기타,2013.06
-540227,0,0,0103100000,540227,23616,번식용,2013.06
-17100,0,0,0106110000,17100,18,영장류,2013.06
-130033,32198,970,0106191000,162231,2547,개,2013.06
-3000,0,0,0106195090,3000,55,기타,2013.06
-484626,30506,618,0106199000,515132,3874,기타,2013.06
-9601,0,0,0106201000,9601,59,뱀,2013.06
-79102,0,0,0106202000,79102,6756,자라,2013.06
-50003,450,4,0106203000,50453,216,거북,2013.06
-62948,0,0,0106209000,62948,136,기타,2013.06
-112842,100,2,0106320000,112942,126,앵무류[패럿류(parrots)ㆍ패러키트류(parakeets)ㆍ금강앵무류ㆍ유황앵무류를 포함한다],2013.06
-29247,0,0,0106419000,29247,1259,기타,2013.06
65319,76554,298,0106490000,11235,182,기타,2013.06
-3978,0,0,0106901000,3978,18,양서류,2013.06
-515469,6388,195,0106903010,521857,36069,갯지렁이,2013.06
-12314,0,0,0106903090,12314,6,기타,2013.06
2732,2732,304,0106909000,0,0,기타,2013.06
-1780761,0,0,0101291000,1780761,25750,경주말,2013.07
-120638,0,0,0103100000,120638,2800,번식용,2013.07
-427022,0,0,0105111000,427022,2260,번식용,2013.07
-12062,0,0,0106110000,12062,28,영장류,2013.07
-1,50,5,0106149000,51,0,기타,2013.07
-228404,36004,935,0106191000,264408,3427,개,2013.07
-23872,0,0,0106195090,23872,64,기타,2013.07
-594004,27371,526,0106199000,621375,4027,기타,2013.07
-23940,0,0,0106201000,23940,36,뱀,2013.07
-142412,0,0,0106202000,142412,12094,자라,2013.07
-103041,0,0,0106203000,103041,341,거북,2013.07
-38879,0,0,0106209000,38879,61,기타,2013.07
-81389,0,0,0106320000,81389,150,앵무류[패럿류(parrots)ㆍ패러키트류(parakeets)ㆍ금강앵무류ㆍ유황앵무류를 포함한다],2013.07
-46473,27,13,0106390000,46500,3,기타,2013.07
-21476,0,0,0106419000,21476,935,기타,2013.07
42159,51179,271,0106490000,9020,86,기타,2013.07
-3239,0,0,0106901000,3239,16,양서류,2013.07
-474054,8472,179,0106903010,482526,32830,갯지렁이,2013.07
-25165,0,0,0106903090,25165,22,기타,2013.07
-2330,0,0,0106909000,2330,9,기타,2013.07
-10566,0,0,0101211000,10566,1000,농가 사육용,2013.08
-361820,0,0,0101291000,361820,7250,경주말,2013.08
-63412,0,0,0101299000,63412,1800,기타,2013.08
-357079,0,0,0103100000,357079,26250,번식용,2013.08
-1629432,0,0,0105111000,1629432,5676,번식용,2013.08
-708876,0,0,0105119000,708876,2662,기타,2013.08
-494336,0,0,0105991010,494336,529,번식용,2013.08
-11096,0,0,0106122000,11096,375,"물개, 바다사자와 바다코끼리(기각아목의 포유동물)",2013.08
-67119,39659,1053,0106191000,106778,1819,개,2013.08
-3600,0,0,0106195010,3600,134,번식용,2013.08
-496086,26008,579,0106199000,522094,4000,기타,2013.08
-64904,0,0,0106201000,64904,111,뱀,2013.08
-80592,0,0,0106202000,80592,6820,자라,2013.08
-53930,0,0,0106203000,53930,1019,거북,2013.08
-27207,0,0,0106209000,27207,107,기타,2013.08
-25895,0,0,0106320000,25895,70,앵무류[패럿류(parrots)ㆍ패러키트류(parakeets)ㆍ금강앵무류ㆍ유황앵무류를 포함한다],2013.08
-23338,0,0,0106390000,23338,25,기타,2013.08
-18637,0,0,0106419000,18637,661,기타,2013.08
-1396,11621,150,0106490000,13017,174,기타,2013.08
-3665,0,0,0106901000,3665,26,양서류,2013.08
-690225,7977,178,0106903010,698202,47290,갯지렁이,2013.08
-7199,0,0,0106903090,7199,10,기타,2013.08
-1076,0,0,0106909000,1076,8,기타,2013.08
-68068,0,0,0101211000,68068,1500,농가 사육용,2013.09
-371389,0,0,0101291000,371389,2000,경주말,2013.09
-177777,0,0,0101299000,177777,4430,기타,2013.09
-630000,0,0,0102211000,630000,3000,젖소,2013.09
-348854,0,0,0103100000,348854,20627,번식용,2013.09
-1206046,0,0,0105111000,1206046,2184,번식용,2013.09
-232408,0,0,0106110000,232408,326,영장류,2013.09
-71,0,0,0106149000,71,5,기타,2013.09
-230259,26600,963,0106191000,256859,2843,개,2013.09
-465607,39131,605,0106199000,504738,3504,기타,2013.09
-39238,0,0,0106201000,39238,1577,뱀,2013.09
-78673,0,0,0106202000,78673,6525,자라,2013.09
-105724,0,0,0106203000,105724,276,거북,2013.09
-42754,0,0,0106209000,42754,589,기타,2013.09
-182925,0,0,0106320000,182925,384,앵무류[패럿류(parrots)ㆍ패러키트류(parakeets)ㆍ금강앵무류ㆍ유황앵무류를 포함한다],2013.09
-2818,0,0,0106390000,2818,20,기타,2013.09
-48388,0,0,0106419000,48388,2440,기타,2013.09
-28079,12630,41,0106490000,40709,766,기타,2013.09
-10941,0,0,0106901000,10941,73,양서류,2013.09
-793869,3205,72,0106903010,797074,53390,갯지렁이,2013.09
-2036,0,0,0106909000,2036,95,기타,2013.09
-250580,0,0,0101211000,250580,1500,농가 사육용,2013.10
-1188386,101531,500,0101291000,1289917,20500,경주말,2013.10
-426529,0,0,0103100000,426529,23321,번식용,2013.10
-250172,0,0,0105991010,250172,265,번식용,2013.10
-12000,0,0,0106110000,12000,72,영장류,2013.10
-52622,0,0,0106122000,52622,320,"물개, 바다사자와 바다코끼리(기각아목의 포유동물)",2013.10
100,100,3,0106149000,0,0,기타,2013.10
-105288,43053,1488,0106191000,148341,1950,개,2013.10
-3600,0,0,0106195090,3600,10,기타,2013.10
-730380,32580,568,0106199000,762960,4907,기타,2013.10
-44006,0,0,0106201000,44006,910,뱀,2013.10
-111654,0,0,0106202000,111654,8656,자라,2013.10
-56841,0,0,0106203000,56841,466,거북,2013.10
-42322,0,0,0106209000,42322,117,기타,2013.10
-35502,0,0,0106320000,35502,105,앵무류[패럿류(parrots)ㆍ패러키트류(parakeets)ㆍ금강앵무류ㆍ유황앵무류를 포함한다],2013.10
-10060,250,60,0106390000,10310,160,기타,2013.10
-79876,0,0,0106419000,79876,1763,기타,2013.10
1246,6916,30,0106490000,5670,57,기타,2013.10
-13002,0,0,0106901000,13002,79,양서류,2013.10
-691802,8364,152,0106903010,700166,47794,갯지렁이,2013.10
-13347,0,0,0106903090,13347,9,기타,2013.10
-111362,0,0,0106909000,111362,1127,기타,2013.10
-426700,0,0,0101211000,426700,20664,농가 사육용,2013.11
-2960002,0,0,0101219000,2960002,4500,기타,2013.11
-798740,0,0,0101291000,798740,17086,경주말,2013.11
-16584,0,0,0101299000,16584,800,기타,2013.11
-280028,0,0,0103100000,280028,16510,번식용,2013.11
-153618,0,0,0105991010,153618,1436,번식용,2013.11
-193600,0,0,0106110000,193600,228,영장류,2013.11
-8104,0,0,0106122000,8104,150,"물개, 바다사자와 바다코끼리(기각아목의 포유동물)",2013.11
-70802,119382,614,0106191000,190184,2420,개,2013.11
-6000,0,0,0106195090,6000,20,기타,2013.11
-559930,28355,580,0106199000,588285,2830,기타,2013.11
-11130,0,0,0106201000,11130,26,뱀,2013.11
-73760,0,0,0106202000,73760,6586,자라,2013.11
-44349,0,0,0106203000,44349,184,거북,2013.11
-33475,0,0,0106209000,33475,185,기타,2013.11
-25382,0,0,0106310000,25382,38,맹금류,2013.11
-84302,0,0,0106320000,84302,241,앵무류[패럿류(parrots)ㆍ패러키트류(parakeets)ㆍ금강앵무류ㆍ유황앵무류를 포함한다],2013.11
-9411,0,0,0106390000,9411,60,기타,2013.11
-64573,0,0,0106419000,64573,1323,기타,2013.11
-2524,74,1,0106490000,2598,77,기타,2013.11
-3794,0,0,0106901000,3794,72,양서류,2013.11
-320189,10627,149,0106903010,330816,22512,갯지렁이,2013.11
-18098,0,0,0106903090,18098,18,기타,2013.11
-64954,0,0,0106909000,64954,981,기타,2013.11
-1813335,0,0,0101211000,1813335,36306,농가 사육용,2013.12
-1370246,4115,500,0101291000,1374361,8300,경주말,2013.12
-230645,0,0,0101299000,230645,7709,기타,2013.12
-16258,0,0,0101309000,16258,8400,기타,2013.12
-101560,0,0,0103100000,101560,4290,번식용,2013.12
-1061556,0,0,0105111000,1061556,4866,번식용,2013.12
-214430,0,0,0106110000,214430,282,영장류,2013.12
-13877,0,0,0106122000,13877,310,"물개, 바다사자와 바다코끼리(기각아목의 포유동물)",2013.12
-117653,34472,448,0106191000,152125,1762,개,2013.12
-33000,0,0,0106194000,33000,50,곰,2013.12
-595290,27774,574,0106199000,623064,2768,기타,2013.12
-21144,0,0,0106201000,21144,61,뱀,2013.12
-41735,0,0,0106202000,41735,3912,자라,2013.12
-24944,100,1,0106203000,25044,227,거북,2013.12
-52975,0,0,0106209000,52975,193,기타,2013.12
-102329,0,0,0106320000,102329,247,앵무류[패럿류(parrots)ㆍ패러키트류(parakeets)ㆍ금강앵무류ㆍ유황앵무류를 포함한다],2013.12
-2565,0,0,0106390000,2565,22,기타,2013.12
-61556,0,0,0106419000,61556,1676,기타,2013.12
-7577,0,0,0106490000,7577,18,기타,2013.12
-31201,0,0,0106901000,31201,1752,양서류,2013.12
-126489,7151,101,0106903010,133640,8918,갯지렁이,2013.12
-12465,0,0,0106903090,12465,9,기타,2013.12
-33590,0,0,0106909000,33590,277,기타,2013.12
-56196545,1637942,24949,-,57834487,1091385,-,총계
-1795190,0,0,0101211000,1795190,44245,농가 사육용,2014.01
-479228,0,0,0101219000,479228,7190,기타,2014.01
-740690,0,0,0101291000,740690,13860,경주말,2014.01
-16948,0,0,0101309000,16948,8400,기타,2014.01
-589656,0,0,0103100000,589656,24376,번식용,2014.01
-784366,0,0,0105111000,784366,2283,번식용,2014.01
-206752,30141,609,0106191000,236893,2959,개,2014.01
-467909,35460,698,0106199000,503369,3257,기타,2014.01
-28566,0,0,0106201000,28566,118,뱀,2014.01
-47487,0,0,0106202000,47487,4500,자라,2014.01
-57298,0,0,0106203000,57298,1879,거북,2014.01
-9018,0,0,0106209000,9018,32,기타,2014.01
-14167,0,0,0106320000,14167,80,앵무류[패럿류(parrots)ㆍ패러키트류(parakeets)ㆍ금강앵무류ㆍ유황앵무류를 포함한다],2014.01
-137332,0,0,0106390000,137332,16,기타,2014.01
-75307,0,0,0106419000,75307,4776,기타,2014.01
-2309,0,0,0106490000,2309,22,기타,2014.01
-2190,0,0,0106901000,2190,18,양서류,2014.01
-121090,7058,123,0106903010,128148,8574,갯지렁이,2014.01
-760,0,0,0106903090,760,68,기타,2014.01
-25545,0,0,0106909000,25545,337,기타,2014.01
-163290,0,0,0101211000,163290,5725,농가 사육용,2014.02
-1536135,0,0,0101291000,1536135,20900,경주말,2014.02
-25000,0,0,0101299000,25000,930,기타,2014.02
-542675,0,0,0105111000,542675,1880,번식용,2014.02
-311606,0,0,0105119000,311606,984,기타,2014.02
-354000,0,0,0106110000,354000,177,영장류,2014.02
17,150,2,0106149000,133,20,기타,2014.02
-229430,30213,758,0106191000,259643,2916,개,2014.02
-559716,33922,625,0106199000,593638,2939,기타,2014.02
-34340,0,0,0106201000,34340,107,뱀,2014.02
-95719,0,0,0106202000,95719,9288,자라,2014.02
-55104,0,0,0106203000,55104,528,거북,2014.02
-35177,0,0,0106209000,35177,120,기타,2014.02
-8000,0,0,0106320000,8000,10,앵무류[패럿류(parrots)ㆍ패러키트류(parakeets)ㆍ금강앵무류ㆍ유황앵무류를 포함한다],2014.02
-45067,0,0,0106390000,45067,360,기타,2014.02
-62941,0,0,0106419000,62941,2886,기타,2014.02
-1898,0,0,0106490000,1898,68,기타,2014.02
-3838,0,0,0106901000,3838,38,양서류,2014.02
-95759,4105,95,0106903010,99864,6636,갯지렁이,2014.02
-10402,0,0,0106903090,10402,9,기타,2014.02
-55641,0,0,0106909000,55641,688,기타,2014.02
-66364,0,0,0101211000,66364,1000,농가 사육용,2014.03
-1019859,0,0,0101291000,1019859,9400,경주말,2014.03
-139393,0,0,0101299000,139393,9900,기타,2014.03
-80266,0,0,0103100000,80266,4732,번식용,2014.03
-297610,0,0,0105111000,297610,1581,번식용,2014.03
-356400,0,0,0106110000,356400,406,영장류,2014.03
-70,0,0,0106149000,70,2,기타,2014.03
-171687,29179,540,0106191000,200866,2669,개,2014.03
-14550,0,0,0106195090,14550,91,기타,2014.03
-660003,29075,1313,0106199000,689078,3249,기타,2014.03
-18907,1100,9,0106201000,20007,58,뱀,2014.03
-64557,0,0,0106202000,64557,5829,자라,2014.03
-35658,0,0,0106203000,35658,454,거북,2014.03
-31290,0,0,0106209000,31290,129,기타,2014.03
-40045,0,0,0106320000,40045,36,앵무류[패럿류(parrots)ㆍ패러키트류(parakeets)ㆍ금강앵무류ㆍ유황앵무류를 포함한다],2014.03
-95196,0,0,0106390000,95196,68,기타,2014.03
-102331,0,0,0106419000,102331,5326,기타,2014.03
-4002,0,0,0106490000,4002,21,기타,2014.03
-4676,0,0,0106901000,4676,33,양서류,2014.03
-205121,4559,102,0106903010,209680,13810,갯지렁이,2014.03
-9456,0,0,0106903090,9456,100,기타,2014.03
-43182,1,1,0106909000,43183,578,기타,2014.03
-2145336,0,0,0101291000,2145336,30210,경주말,2014.04
-1096956,0,0,0101299000,1096956,6500,기타,2014.04
-16858,0,0,0101309000,16858,8400,기타,2014.04
-249739,0,0,0103100000,249739,8499,번식용,2014.04
-105764,0,0,0105119000,105764,2925,기타,2014.04
-16352,0,0,0106122000,16352,180,"물개, 바다사자와 바다코끼리(기각아목의 포유동물)",2014.04
-190,0,0,0106149000,190,14,기타,2014.04
-180744,29272,914,0106191000,210016,2472,개,2014.04
-4000,0,0,0106195090,4000,150,기타,2014.04
-510649,35552,695,0106199000,546201,3613,기타,2014.04
-18918,0,0,0106201000,18918,108,뱀,2014.04
-141120,0,0,0106202000,141120,12837,자라,2014.04
-76829,0,0,0106203000,76829,490,거북,2014.04
-63891,0,0,0106209000,63891,406,기타,2014.04
-43320,0,0,0106320000,43320,70,앵무류[패럿류(parrots)ㆍ패러키트류(parakeets)ㆍ금강앵무류ㆍ유황앵무류를 포함한다],2014.04
-47516,0,0,0106390000,47516,354,기타,2014.04
-79463,0,0,0106419000,79463,3623,기타,2014.04
-4362,266,5,0106490000,4628,30,기타,2014.04
-15540,2990,80,0106901000,18530,61,양서류,2014.04
-316736,7396,162,0106903010,324132,22272,갯지렁이,2014.04
-200,0,0,0106903020,200,100,실지렁이,2014.04
-10377,0,0,0106903090,10377,22,기타,2014.04
-23317,10522,448,0106909000,33839,803,기타,2014.04
-21850,0,0,0101219000,21850,878,기타,2014.05
-3589993,0,0,0101291000,3589993,36700,경주말,2014.05
-1389373,243831,1000,0101299000,1633204,6400,기타,2014.05
-330000,0,0,0102211000,330000,1400,젖소,2014.05
-81836,0,0,0103100000,81836,4492,번식용,2014.05
-534273,0,0,0105111000,534273,2490,번식용,2014.05
11,11,0,0106110000,0,0,영장류,2014.05
-461,0,0,0106149000,461,3,기타,2014.05
-196136,33823,1410,0106191000,229959,2464,개,2014.05
-583363,30993,598,0106199000,614356,4947,기타,2014.05
-30603,0,0,0106201000,30603,203,뱀,2014.05
-66578,0,0,0106202000,66578,6394,자라,2014.05
-36483,0,0,0106203000,36483,300,거북,2014.05
-45464,0,0,0106209000,45464,128,기타,2014.05
-25936,100,1,0106320000,26036,64,앵무류[패럿류(parrots)ㆍ패러키트류(parakeets)ㆍ금강앵무류ㆍ유황앵무류를 포함한다],2014.05
-62149,0,0,0106419000,62149,3095,기타,2014.05
-1787,0,0,0106490000,1787,11,기타,2014.05
-5976,7035,120,0106901000,13011,55,양서류,2014.05
-552677,6359,141,0106903010,559036,38776,갯지렁이,2014.05
-10230,0,0,0106903090,10230,15,기타,2014.05
-14676,0,0,0106909000,14676,370,기타,2014.05
-1306517,0,0,0101291000,1306517,19500,경주말,2014.06
-66419,0,0,0101299000,66419,3500,기타,2014.06
-273279,0,0,0103100000,273279,10068,번식용,2014.06
-473164,0,0,0105139000,473164,20500,기타,2014.06
-482100,0,0,0106110000,482100,493,영장류,2014.06
-115195,40430,1546,0106191000,155625,1846,개,2014.06
-599042,27092,528,0106199000,626134,4103,기타,2014.06
-14224,0,0,0106201000,14224,62,뱀,2014.06
-106255,0,0,0106202000,106255,9627,자라,2014.06
-36099,0,0,0106203000,36099,163,거북,2014.06
-61972,0,0,0106209000,61972,157,기타,2014.06
-15287,0,0,0106320000,15287,74,앵무류[패럿류(parrots)ㆍ패러키트류(parakeets)ㆍ금강앵무류ㆍ유황앵무류를 포함한다],2014.06
-56601,0,0,0106419000,56601,2823,기타,2014.06
-3458,118,8,0106490000,3576,11,기타,2014.06
-11062,0,0,0106901000,11062,59,양서류,2014.06
-538949,8145,184,0106903010,547094,38151,갯지렁이,2014.06
-16535,0,0,0106903090,16535,70,기타,2014.06
-211973,0,0,0106909000,211973,2809,기타,2014.06
-197082,0,0,0101211000,197082,500,농가 사육용,2014.07
-4538191,0,0,0101291000,4538191,86745,경주말,2014.07
-509899,485997,500,0101299000,995896,19000,기타,2014.07
-190168,0,0,0103100000,190168,8000,번식용,2014.07
-180320,0,0,0103920000,180320,6177,중량이 50킬로그램 이상인 것,2014.07
-1595235,0,0,0105111000,1595235,10837,번식용,2014.07
-333453,0,0,0105119000,333453,10869,기타,2014.07
-157233,0,0,0105139000,157233,7500,기타,2014.07
-274013,0,0,0105991010,274013,264,번식용,2014.07
8,8,0,0106110000,0,0,영장류,2014.07
-180575,27376,1115,0106191000,207951,2647,개,2014.07
-16870,0,0,0106195090,16870,100,기타,2014.07
-593963,33477,699,0106199000,627440,3789,기타,2014.07
-31397,220,1,0106201000,31617,59,뱀,2014.07
-93528,0,0,0106202000,93528,8191,자라,2014.07
-120750,240,1,0106203000,120990,511,거북,2014.07
-43950,985,1,0106209000,44935,202,기타,2014.07
-134105,0,0,0106320000,134105,340,앵무류[패럿류(parrots)ㆍ패러키트류(parakeets)ㆍ금강앵무류ㆍ유황앵무류를 포함한다],2014.07
-221000,0,0,0106390000,221000,60,기타,2014.07
-56655,0,0,0106419000,56655,2458,기타,2014.07
-1330,0,0,0106490000,1330,5,기타,2014.07
-9567,0,0,0106901000,9567,89,양서류,2014.07
-605828,8373,193,0106903010,614201,42218,갯지렁이,2014.07
-6974,0,0,0106903090,6974,109,기타,2014.07
-16054,0,0,0106909000,16054,402,기타,2014.07
-147913,0,0,0101291000,147913,2500,경주말,2014.08
-141260,0,0,0101299000,141260,3900,기타,2014.08
-1451688,0,0,0105111000,1451688,5063,번식용,2014.08
-539463,0,0,0105991010,539463,530,번식용,2014.08
-92800,0,0,0106110000,92800,174,영장류,2014.08
-95029,0,0,0106130000,95029,7500,낙타와 그 밖의 낙타과의 동물[카멜리대(Camelidae)과],2014.08
-40,150,4,0106149000,190,21,기타,2014.08
-96208,29521,899,0106191000,125729,1438,개,2014.08
-505710,36213,773,0106199000,541923,3501,기타,2014.08
-45843,0,0,0106201000,45843,446,뱀,2014.08
-113255,0,0,0106202000,113255,7916,자라,2014.08
-103930,0,0,0106203000,103930,268,거북,2014.08
-13983,0,0,0106209000,13983,75,기타,2014.08
-10819,0,0,0106320000,10819,15,앵무류[패럿류(parrots)ㆍ패러키트류(parakeets)ㆍ금강앵무류ㆍ유황앵무류를 포함한다],2014.08
-39844,0,0,0106419000,39844,2216,기타,2014.08
-2722,0,0,0106490000,2722,7,기타,2014.08
-2321,0,0,0106901000,2321,78,양서류,2014.08
-675112,13148,139,0106903010,688260,46153,갯지렁이,2014.08
-12275,0,0,0106903090,12275,9,기타,2014.08
-14299,0,0,0106909000,14299,437,기타,2014.08
-110852,0,0,0101291000,110852,1400,경주말,2014.09
-6000,0,0,0101299000,6000,1000,기타,2014.09
-657000,0,0,0102211000,657000,2500,젖소,2014.09
-1337411,0,0,0105111000,1337411,1949,번식용,2014.09
-26327,0,0,0105119000,26327,396,기타,2014.09
-261621,0,0,0105991010,261621,265,번식용,2014.09
-252000,0,0,0106110000,252000,287,영장류,2014.09
-305246,46423,956,0106191000,351669,3580,개,2014.09
-8000,0,0,0106195010,8000,126,번식용,2014.09
-594857,36170,508,0106199000,631027,3534,기타,2014.09
-21619,0,0,0106201000,21619,677,뱀,2014.09
-89420,0,0,0106202000,89420,7416,자라,2014.09
-80077,0,0,0106203000,80077,526,거북,2014.09
-13187,0,0,0106209000,13187,132,기타,2014.09
-80816,0,0,0106320000,80816,200,앵무류[패럿류(parrots)ㆍ패러키트류(parakeets)ㆍ금강앵무류ㆍ유황앵무류를 포함한다],2014.09
-57806,0,0,0106419000,57806,2431,기타,2014.09
-2374,0,0,0106490000,2374,13,기타,2014.09
-7021,0,0,0106901000,7021,78,양서류,2014.09
-907171,5846,130,0106903010,913017,61143,갯지렁이,2014.09
-68227,0,0,0106909000,68227,1840,기타,2014.09
-206606,0,0,0101211000,206606,1900,농가 사육용,2014.10
-2235870,0,0,0101291000,2235870,27961,경주말,2014.10
-327632,0,0,0101299000,327632,5700,기타,2014.10
-302538,0,0,0102211000,302538,1456,젖소,2014.10
-434630,0,0,0105111000,434630,2202,번식용,2014.10
-64782,0,0,0105119000,64782,2171,기타,2014.10
-38298,0,0,0106110000,38298,45,영장류,2014.10
-42016,0,0,0106122000,42016,190,"물개, 바다사자와 바다코끼리(기각아목의 포유동물)",2014.10
-186700,48022,957,0106191000,234722,3006,개,2014.10
-603679,42970,777,0106199000,646649,4004,기타,2014.10
-54805,0,0,0106201000,54805,1670,뱀,2014.10
-97465,0,0,0106202000,97465,8086,자라,2014.10
-107361,0,0,0106203000,107361,400,거북,2014.10
-63038,0,0,0106209000,63038,205,기타,2014.10
-75370,100,1,0106320000,75470,235,앵무류[패럿류(parrots)ㆍ패러키트류(parakeets)ㆍ금강앵무류ㆍ유황앵무류를 포함한다],2014.10
-51000,0,0,0106390000,51000,30,기타,2014.10
-58929,0,0,0106419000,58929,1605,기타,2014.10
-4377,0,0,0106490000,4377,47,기타,2014.10
-12438,0,0,0106901000,12438,153,양서류,2014.10
-765339,3178,75,0106903010,768517,51689,갯지렁이,2014.10
-20836,0,0,0106903090,20836,16,기타,2014.10
-85568,0,0,0106909000,85568,1641,기타,2014.10
-300160,0,0,0101211000,300160,3455,농가 사육용,2014.11
-2556892,0,0,0101219000,2556892,2000,기타,2014.11
-697204,0,0,0101291000,697204,11885,경주말,2014.11
-2046906,0,0,0103100000,2046906,98486,번식용,2014.11
-161921,0,0,0105111000,161921,954,번식용,2014.11
-42000,0,0,0106110000,42000,105,영장류,2014.11
-16500,0,0,0106122000,16500,180,"물개, 바다사자와 바다코끼리(기각아목의 포유동물)",2014.11
-27,0,0,0106149000,27,12,기타,2014.11
-144719,35644,931,0106191000,180363,2341,개,2014.11
-609282,24928,383,0106199000,634210,3510,기타,2014.11
-39052,0,0,0106201000,39052,97,뱀,2014.11
-52716,0,0,0106202000,52716,4581,자라,2014.11
-55012,0,0,0106203000,55012,880,거북,2014.11
-37088,0,0,0106209000,37088,88,기타,2014.11
-35453,0,0,0106320000,35453,68,앵무류[패럿류(parrots)ㆍ패러키트류(parakeets)ㆍ금강앵무류ㆍ유황앵무류를 포함한다],2014.11
-6020,0,0,0106390000,6020,40,기타,2014.11
-66935,0,0,0106419000,66935,2439,기타,2014.11
-2498,0,0,0106490000,2498,76,기타,2014.11
-7096,0,0,0106901000,7096,114,양서류,2014.11
-422784,3560,83,0106903010,426344,29212,갯지렁이,2014.11
-12178,0,0,0106903090,12178,12,기타,2014.11
-51169,0,0,0106909000,51169,931,기타,2014.11
-3558152,0,0,0101211000,3558152,67777,농가 사육용,2014.12
-481175,0,0,0101219000,481175,6060,기타,2014.12
-1282658,180000,500,0101291000,1462658,30193,경주말,2014.12
-112352,0,0,0101299000,112352,2690,기타,2014.12
-9340,0,0,0105111000,9340,212,번식용,2014.12
-278229,0,0,0105131000,278229,949,번식용,2014.12
-389629,0,0,0106110000,389629,389,영장류,2014.12
-13698,0,0,0106122000,13698,70,"물개, 바다사자와 바다코끼리(기각아목의 포유동물)",2014.12
-167,0,0,0106149000,167,2,기타,2014.12
-150941,38288,954,0106191000,189229,2605,개,2014.12
-515688,26978,528,0106199000,542666,3236,기타,2014.12
-19450,0,0,0106201000,19450,41,뱀,2014.12
-80081,0,0,0106202000,80081,6943,자라,2014.12
-10382,0,0,0106203000,10382,212,거북,2014.12
-39839,0,0,0106209000,39839,82,기타,2014.12
-8202,0,0,0106320000,8202,40,앵무류[패럿류(parrots)ㆍ패러키트류(parakeets)ㆍ금강앵무류ㆍ유황앵무류를 포함한다],2014.12
-6874,0,0,0106390000,6874,10,기타,2014.12
-57957,0,0,0106419000,57957,2383,기타,2014.12
-2764,0,0,0106490000,2764,11,기타,2014.12
-24677,0,0,0106901000,24677,1146,양서류,2014.12
-126944,3213,93,0106903010,130157,8788,갯지렁이,2014.12
-16571,0,0,0106903090,16571,10,기타,2014.12
-28817,0,0,0106909000,28817,392,기타,2014.12
-69941447,1819926,23910,-,71761373,1363942,-,총계
-1852583,0,0,0101211000,1852583,31050,농가 사육용,2015.01
-17208,0,0,0101219000,17208,880,기타,2015.01
-69266,3360,500,0101291000,72626,2500,경주말,2015.01
-517001,0,0,0101299000,517001,25665,기타,2015.01
-60612,0,0,0103100000,60612,2015,번식용,2015.01
-420000,0,0,0106110000,420000,376,영장류,2015.01
-108277,43039,1677,0106191000,151316,2111,개,2015.01
-455483,30838,671,0106199000,486321,2977,기타,2015.01
-20368,0,0,0106201000,20368,114,뱀,2015.01
-75460,0,0,0106202000,75460,6471,자라,2015.01
-12193,0,0,0106203000,12193,312,거북,2015.01
-35674,0,0,0106209000,35674,54,기타,2015.01
-21235,0,0,0106320000,21235,20,앵무류[패럿류(parrots)ㆍ패러키트류(parakeets)ㆍ금강앵무류ㆍ유황앵무류를 포함한다],2015.01
-70278,0,0,0106419000,70278,4164,기타,2015.01
-1551,0,3,0106490000,1551,14,기타,2015.01
-19589,0,0,0106901000,19589,1078,양서류,2015.01
-141407,2040,45,0106903010,143447,9905,갯지렁이,2015.01
-9992,0,0,0106903090,9992,11,기타,2015.01
-14626,0,0,0106909000,14626,423,기타,2015.01
-10000,0,0,0101211000,10000,450,농가 사육용,2015.02
-233941,0,0,0101291000,233941,21480,경주말,2015.02
-149050,0,0,0101299000,149050,19080,기타,2015.02
-69373,0,0,0103100000,69373,3735,번식용,2015.02
-792475,0,0,0105111000,792475,4434,번식용,2015.02
-12475,0,0,0106122000,12475,50,"물개, 바다사자와 바다코끼리(기각아목의 포유동물)",2015.02
-77,100,1,0106149000,177,10,기타,2015.02
-58399,45932,1001,0106191000,104331,1717,개,2015.02
-440625,23248,490,0106199000,463873,2701,기타,2015.02
-38540,0,0,0106201000,38540,58,뱀,2015.02
-52414,0,0,0106202000,52414,5057,자라,2015.02
-77655,0,0,0106203000,77655,2406,거북,2015.02
-23930,0,0,0106209000,23930,128,기타,2015.02
-17462,0,0,0106320000,17462,34,앵무류[패럿류(parrots)ㆍ패러키트류(parakeets)ㆍ금강앵무류ㆍ유황앵무류를 포함한다],2015.02
-67126,0,0,0106419000,67126,3525,기타,2015.02
-641,0,3,0106490000,641,106,기타,2015.02
-7551,0,0,0106901000,7551,67,양서류,2015.02
-176084,2168,48,0106903010,178252,12340,갯지렁이,2015.02
-13,0,0,0106903090,13,2,기타,2015.02
-32946,0,0,0106909000,32946,988,기타,2015.02
-804794,0,0,0101291000,804794,8400,경주말,2015.03
-731454,0,0,0101299000,731454,14700,기타,2015.03
-210000,0,0,0106110000,210000,148,영장류,2015.03
100,100,1,0106149000,0,0,기타,2015.03
-184732,45755,3061,0106191000,230487,2253,개,2015.03
-957,0,0,0106195090,957,20,기타,2015.03
-487276,29133,582,0106199000,516409,3650,기타,2015.03
-12203,0,0,0106201000,12203,34,뱀,2015.03
-114723,0,0,0106202000,114723,9882,자라,2015.03
-31739,400,2,0106203000,32139,707,거북,2015.03
-26217,0,0,0106209000,26217,182,기타,2015.03
-60425,0,0,0106320000,60425,77,앵무류[패럿류(parrots)ㆍ패러키트류(parakeets)ㆍ금강앵무류ㆍ유황앵무류를 포함한다],2015.03
-5372,0,0,0106390000,5372,29,기타,2015.03
-110000,0,0,0106419000,110000,5907,기타,2015.03
-3430,0,0,0106490000,3430,53,기타,2015.03
-5967,0,0,0106901000,5967,138,양서류,2015.03
-309032,4603,103,0106903010,313635,21798,갯지렁이,2015.03
-6608,0,0,0106903090,6608,7,기타,2015.03
-53908,0,0,0106909000,53908,1627,기타,2015.03
-562480,0,0,0101211000,562480,36600,농가 사육용,2015.04
-34704,0,0,0101219000,34704,1300,기타,2015.04
-3108901,0,0,0101291000,3108901,34000,경주말,2015.04
-151514,0,0,0101299000,151514,1500,기타,2015.04
-161784,0,0,0103100000,161784,6800,번식용,2015.04
-704911,0,0,0105111000,704911,3023,번식용,2015.04
-176689,45190,1353,0106191000,221879,2291,개,2015.04
1,1,7,0106195090,0,0,기타,2015.04
-616864,27665,572,0106199000,644529,3349,기타,2015.04
-45618,0,0,0106201000,45618,221,뱀,2015.04
-120864,0,0,0106202000,120864,10044,자라,2015.04
-53180,0,0,0106203000,53180,830,거북,2015.04
-17901,0,0,0106209000,17901,54,기타,2015.04
-6404,0,0,0106320000,6404,5,앵무류[패럿류(parrots)ㆍ패러키트류(parakeets)ㆍ금강앵무류ㆍ유황앵무류를 포함한다],2015.04
-7462,0,0,0106390000,7462,28,기타,2015.04
-93704,0,0,0106419000,93704,5182,기타,2015.04
-5726,0,0,0106490000,5726,46,기타,2015.04
-11905,3067,90,0106901000,14972,210,양서류,2015.04
-452044,2635,60,0106903010,454679,31735,갯지렁이,2015.04
-8706,0,0,0106903090,8706,144,기타,2015.04
-20795,6963,336,0106909000,27758,902,기타,2015.04
-1728896,0,0,0101291000,1728896,25950,경주말,2015.05
-7400,0,0,0101299000,7400,833,기타,2015.05
-75916,0,0,0103100000,75916,3765,번식용,2015.05
-105685,0,0,0103920000,105685,1280,중량이 50킬로그램 이상인 것,2015.05
-517928,12000,96,0105111000,529928,1097,번식용,2015.05
-35524,0,0,0105131000,35524,584,번식용,2015.05
-322000,0,0,0106110000,322000,360,영장류,2015.05
-44000,0,0,0106122000,44000,400,"물개, 바다사자와 바다코끼리(기각아목의 포유동물)",2015.05
-2014,200,1,0106149000,2214,30,기타,2015.05
-183869,40796,2083,0106191000,224665,2650,개,2015.05
-3036,0,0,0106195090,3036,50,기타,2015.05
-527619,24127,531,0106199000,551746,3109,기타,2015.05
-28641,0,0,0106201000,28641,82,뱀,2015.05
-84117,0,0,0106202000,84117,7477,자라,2015.05
-60443,0,0,0106203000,60443,218,거북,2015.05
-1604,26000,1,0106209000,27604,160,기타,2015.05
-43354,0,0,0106320000,43354,53,앵무류[패럿류(parrots)ㆍ패러키트류(parakeets)ㆍ금강앵무류ㆍ유황앵무류를 포함한다],2015.05
-11604,0,0,0106390000,11604,10,기타,2015.05
-54230,0,0,0106419000,54230,2415,기타,2015.05
-4580,0,0,0106490000,4580,44,기타,2015.05
-5943,7827,107,0106901000,13770,143,양서류,2015.05
-697810,3540,80,0106903010,701350,48806,갯지렁이,2015.05
-6208,0,0,0106903090,6208,209,기타,2015.05
-21103,0,0,0106909000,21103,454,기타,2015.05
-11600,0,0,0101211000,11600,1200,농가 사육용,2015.06
-4467757,2586,500,0101291000,4470343,52100,경주말,2015.06
-656016,0,0,0101299000,656016,11560,기타,2015.06
-59292,0,0,0101309000,59292,7820,기타,2015.06
-879156,0,0,0103100000,879156,36800,번식용,2015.06
-356843,0,0,0105111000,356843,952,번식용,2015.06
-109367,0,0,0105131000,109367,1752,번식용,2015.06
482,482,6,0106149000,0,0,기타,2015.06
-196593,27951,1571,0106191000,224544,2925,개,2015.06
-2000,0,0,0106195090,2000,10,기타,2015.06
-440957,30221,633,0106199000,471178,3509,기타,2015.06
-9224,0,0,0106201000,9224,59,뱀,2015.06
-113926,0,0,0106202000,113926,9317,자라,2015.06
-28860,0,0,0106203000,28860,513,거북,2015.06
-50653,0,0,0106209000,50653,245,기타,2015.06
-8476,0,0,0106320000,8476,10,앵무류[패럿류(parrots)ㆍ패러키트류(parakeets)ㆍ금강앵무류ㆍ유황앵무류를 포함한다],2015.06
-92550,0,0,0106390000,92550,50,기타,2015.06
-50485,0,0,0106419000,50485,2348,기타,2015.06
-4089,0,0,0106490000,4089,60,기타,2015.06
-8531,0,0,0106901000,8531,137,양서류,2015.06
-596697,4466,100,0106903010,601163,41631,갯지렁이,2015.06
-6711,0,0,0106903090,6711,7,기타,2015.06
-15360,0,0,0106909000,15360,723,기타,2015.06
-141817,0,0,0101211000,141817,900,농가 사육용,2015.07
-748085,0,0,0101291000,748085,5900,경주말,2015.07
-998602,0,0,0101299000,998602,16500,기타,2015.07
-1019324,0,0,0103100000,1019324,45880,번식용,2015.07
-1368272,0,0,0105111000,1368272,6914,번식용,2015.07
-166477,0,0,0105131000,166477,269,번식용,2015.07
-253473,0,0,0105991010,253473,265,번식용,2015.07
-406467,0,0,0106110000,406467,442,영장류,2015.07
100,100,1,0106149000,0,0,기타,2015.07
-147470,35265,1663,0106191000,182735,2562,개,2015.07
-4136,0,0,0106195090,4136,55,기타,2015.07
-676614,25358,594,0106199000,701972,4193,기타,2015.07
-13958,0,0,0106201000,13958,611,뱀,2015.07
-125901,0,0,0106202000,125901,10539,자라,2015.07
-112273,100,1,0106203000,112373,256,거북,2015.07
-10764,4750,4,0106209000,15514,29,기타,2015.07
-54591,0,0,0106320000,54591,139,앵무류[패럿류(parrots)ㆍ패러키트류(parakeets)ㆍ금강앵무류ㆍ유황앵무류를 포함한다],2015.07
-29263,0,0,0106419000,29263,1847,기타,2015.07
-3267,0,0,0106490000,3267,45,기타,2015.07
-6452,0,0,0106901000,6452,136,양서류,2015.07
-625047,6737,148,0106903010,631784,43465,갯지렁이,2015.07
-5434,0,0,0106903090,5434,173,기타,2015.07
-6618,5,1,0106909000,6623,277,기타,2015.07
-248523,0,0,0101291000,248523,4500,경주말,2015.08
-76184,0,0,0101299000,76184,3500,기타,2015.08
-331144,0,0,0103100000,331144,16760,번식용,2015.08
-1976931,12660,96,0105111000,1989591,13606,번식용,2015.08
-23671,0,0,0105119000,23671,396,기타,2015.08
-263020,0,0,0106110000,263020,300,영장류,2015.08
-141855,37364,1592,0106191000,179219,1896,개,2015.08
-22500,0,0,0106195010,22500,186,번식용,2015.08
-2250,0,0,0106195090,2250,20,기타,2015.08
-399739,20771,507,0106199000,420510,2367,기타,2015.08
-15845,0,0,0106201000,15845,48,뱀,2015.08
-80607,0,0,0106202000,80607,6956,자라,2015.08
-64074,100,1,0106203000,64174,72,거북,2015.08
-31577,0,0,0106209000,31577,116,기타,2015.08
-120480,0,0,0106320000,120480,135,앵무류[패럿류(parrots)ㆍ패러키트류(parakeets)ㆍ금강앵무류ㆍ유황앵무류를 포함한다],2015.08
-7209,0,0,0106390000,7209,30,기타,2015.08
-21150,0,0,0106419000,21150,1233,기타,2015.08
-2469,0,0,0106490000,2469,23,기타,2015.08
-7895,0,0,0106901000,7895,80,양서류,2015.08
-775500,3672,81,0106903010,779172,53526,갯지렁이,2015.08
-7024,0,0,0106903090,7024,66,기타,2015.08
-10539,0,0,0106909000,10539,366,기타,2015.08
-183361,0,0,0101291000,183361,7500,경주말,2015.09
-102573,0,0,0101299000,102573,3000,기타,2015.09
-630000,0,0,0102211000,630000,4264,젖소,2015.09
-448491,0,0,0103100000,448491,16020,번식용,2015.09
-4932,0,0,0103910000,4932,21,중량이 50킬로그램 미만인 것,2015.09
-537576,0,0,0105111000,537576,4096,번식용,2015.09
-208202,0,0,0105131000,208202,239,번식용,2015.09
-80382,0,0,0106110000,80382,100,영장류,2015.09
-126185,48700,5232,0106191000,174885,1560,개,2015.09
-481284,37971,722,0106199000,519255,2905,기타,2015.09
-40662,0,0,0106201000,40662,253,뱀,2015.09
-70708,0,0,0106202000,70708,6565,자라,2015.09
-51330,0,0,0106203000,51330,433,거북,2015.09
-61432,0,0,0106209000,61432,270,기타,2015.09
-50738,0,0,0106320000,50738,211,앵무류[패럿류(parrots)ㆍ패러키트류(parakeets)ㆍ금강앵무류ㆍ유황앵무류를 포함한다],2015.09
-71471,0,0,0106419000,71471,3789,기타,2015.09
-1168,0,0,0106490000,1168,6,기타,2015.09
-10590,0,0,0106901000,10590,161,양서류,2015.09
-770793,4360,96,0106903010,775153,52902,갯지렁이,2015.09
-1460,0,0,0106903020,1460,10,실지렁이,2015.09
-16956,0,0,0106903090,16956,15,기타,2015.09
-54189,0,0,0106909000,54189,1626,기타,2015.09
-571176,0,0,0101291000,571176,6500,경주말,2015.10
-68442,0,0,0101309000,68442,10200,기타,2015.10
-668199,0,0,0103100000,668199,28590,번식용,2015.10
-30937,0,0,0103910000,30937,192,중량이 50킬로그램 미만인 것,2015.10
-814423,14400,96,0105111000,828823,8573,번식용,2015.10
-49547,0,0,0105119000,49547,1056,기타,2015.10
-263010,0,0,0105131000,263010,422,번식용,2015.10
-383508,0,0,0106110000,383508,177,영장류,2015.10
-172887,34578,1250,0106191000,207465,1969,개,2015.10
-551268,31727,661,0106199000,582995,4029,기타,2015.10
-20168,0,0,0106201000,20168,1209,뱀,2015.10
-55493,0,0,0106202000,55493,4864,자라,2015.10
-61709,0,0,0106203000,61709,301,거북,2015.10
-18881,0,0,0106209000,18881,337,기타,2015.10
-36690,0,0,0106320000,36690,16,앵무류[패럿류(parrots)ㆍ패러키트류(parakeets)ㆍ금강앵무류ㆍ유황앵무류를 포함한다],2015.10
-10808,0,0,0106390000,10808,35,기타,2015.10
-78721,0,0,0106419000,78721,2394,기타,2015.10
-12117,526,6,0106490000,12643,20,기타,2015.10
-2912,0,0,0106901000,2912,177,양서류,2015.10
-781201,2043,45,0106903010,783244,53176,갯지렁이,2015.10
-122,0,0,0106903020,122,2,실지렁이,2015.10
-1706,0,0,0106903090,1706,69,기타,2015.10
-100318,0,0,0106909000,100318,2760,기타,2015.10
-182160,0,0,0101211000,182160,7066,농가 사육용,2015.11
-16531,0,0,0101219000,16531,500,기타,2015.11
-1166108,0,0,0101291000,1166108,16929,경주말,2015.11
-421965,0,0,0101299000,421965,6000,기타,2015.11
-217950,0,0,0103100000,217950,13879,번식용,2015.11
-1616666,0,0,0105111000,1616666,10630,번식용,2015.11
-55804,0,0,0105119000,55804,2171,기타,2015.11
-17000,0,0,0106110000,17000,109,영장류,2015.11
-242489,50634,1515,0106191000,293123,2743,개,2015.11
-535,0,0,0106195090,535,18,기타,2015.11
-567255,33532,712,0106199000,600787,2968,기타,2015.11
-30958,0,0,0106201000,30958,74,뱀,2015.11
-66992,0,0,0106202000,66992,5966,자라,2015.11
-38772,0,0,0106203000,38772,83,거북,2015.11
-63232,2200,6,0106209000,65432,654,기타,2015.11
-61622,0,0,0106320000,61622,120,앵무류[패럿류(parrots)ㆍ패러키트류(parakeets)ㆍ금강앵무류ㆍ유황앵무류를 포함한다],2015.11
-1994,0,0,0106390000,1994,20,기타,2015.11
-78010,0,0,0106419000,78010,3623,기타,2015.11
-2091,0,0,0106490000,2091,18,기타,2015.11
-10810,0,0,0106901000,10810,148,양서류,2015.11
-355679,1023,23,0106903010,356702,24661,갯지렁이,2015.11
-2862,0,0,0106903090,2862,5,기타,2015.11
-40329,0,0,0106909000,40329,1212,기타,2015.11
-4325353,0,0,0101211000,4325353,69828,농가 사육용,2015.12
-687262,0,0,0101219000,687262,10181,기타,2015.12
-365072,0,0,0101291000,365072,4541,경주말,2015.12
86667,130937,500,0101299000,44270,1500,기타,2015.12
-271812,0,0,0102211000,271812,1540,젖소,2015.12
-161802,0,0,0103100000,161802,13640,번식용,2015.12
-1012141,0,0,0105111000,1012141,6430,번식용,2015.12
-146163,0,0,0106110000,146163,28,영장류,2015.12
-128972,59304,1594,0106191000,188276,2104,개,2015.12
-499765,32107,715,0106199000,531872,3382,기타,2015.12
-12018,0,0,0106201000,12018,86,뱀,2015.12
-74668,0,0,0106202000,74668,6729,자라,2015.12
-66821,200,1,0106203000,67021,397,거북,2015.12
-26034,0,0,0106209000,26034,117,기타,2015.12
-42001,0,0,0106320000,42001,55,앵무류[패럿류(parrots)ㆍ패러키트류(parakeets)ㆍ금강앵무류ㆍ유황앵무류를 포함한다],2015.12
-38217,0,0,0106390000,38217,29,기타,2015.12
-49205,0,0,0106419000,49205,2282,기타,2015.12
-2885,0,0,0106490000,2885,21,기타,2015.12
-42650,0,0,0106901000,42650,4488,양서류,2015.12
-263532,2047,45,0106903010,265579,17912,갯지렁이,2015.12
-16145,0,0,0106903090,16145,14,기타,2015.12
-31905,0,0,0106909000,31905,492,기타,2015.12
-62191344,1129604,34217,-,63320948,1376277,-,총계
-708480,0,0,0101211000,708480,8600,농가 사육용,2016.01
-519540,0,0,0101219000,519540,3050,기타,2016.01
-43107,0,0,0101291000,43107,1000,경주말,2016.01
-60091,0,0,0101299000,60091,2500,기타,2016.01
-293413,0,0,0103100000,293413,9970,번식용,2016.01
-1555790,0,0,0105111000,1555790,4796,번식용,2016.01
-255000,0,0,0106110000,255000,448,영장류,2016.01
-12500,0,0,0106122000,12500,300,"물개, 바다사자와 바다코끼리(기각아목의 포유동물)",2016.01
-56,0,0,0106149000,56,5,기타,2016.01
-120575,38182,1553,0106191000,158757,1881,개,2016.01
-558205,29455,692,0106199000,587660,3362,기타,2016.01
-16623,0,0,0106201000,16623,56,뱀,2016.01
-75697,0,0,0106202000,75697,6698,자라,2016.01
-87237,0,0,0106203000,87237,188,거북,2016.01
-11650,700,6,0106209000,12350,36,기타,2016.01
-31497,0,0,0106320000,31497,82,앵무류[패럿류(parrots)ㆍ패러키트류(parakeets)ㆍ금강앵무류ㆍ유황앵무류를 포함한다],2016.01
-8742,0,0,0106390000,8742,70,기타,2016.01
-73279,0,0,0106419000,73279,4454,기타,2016.01
-2862,0,0,0106490000,2862,10,기타,2016.01
-39551,0,0,0106901000,39551,3644,양서류,2016.01
-160210,0,0,0106903010,160210,10410,갯지렁이,2016.01
-6873,0,0,0106903090,6873,23,기타,2016.01
-22975,0,0,0106909000,22975,1098,기타,2016.01
-896556,0,0,0101211000,896556,5500,농가 사육용,2016.02
-14473,0,0,0101219000,14473,1000,기타,2016.02
-965896,0,0,0101291000,965896,13500,경주말,2016.02
-86763,0,0,0101299000,86763,3000,기타,2016.02
-57751,0,0,0103100000,57751,14535,번식용,2016.02
-1549558,0,0,0105111000,1549558,7889,번식용,2016.02
-215000,0,0,0106110000,215000,245,영장류,2016.02
183,183,10,0106149000,0,0,기타,2016.02
-190547,56420,3221,0106191000,246967,2055,개,2016.02
-476293,26543,589,0106199000,502836,2358,기타,2016.02
-37696,0,0,0106201000,37696,29,뱀,2016.02
-49596,0,0,0106202000,49596,4735,자라,2016.02
-63995,0,0,0106203000,63995,3088,거북,2016.02
-14025,0,0,0106209000,14025,79,기타,2016.02
-111151,0,0,0106320000,111151,225,앵무류[패럿류(parrots)ㆍ패러키트류(parakeets)ㆍ금강앵무류ㆍ유황앵무류를 포함한다],2016.02
-30019,0,0,0106390000,30019,175,기타,2016.02
-118396,0,0,0106419000,118396,6031,기타,2016.02
-839,0,0,0106490000,839,16,기타,2016.02
-16861,0,0,0106901000,16861,546,양서류,2016.02
-208675,0,0,0106903010,208675,13313,갯지렁이,2016.02
-240,0,0,0106903090,240,0,기타,2016.02
-65769,0,0,0106909000,65769,2759,기타,2016.02
-20000,0,0,0101211000,20000,450,농가 사육용,2016.03
-2332393,0,0,0101291000,2332393,34100,경주말,2016.03
-97523,0,0,0101299000,97523,3000,기타,2016.03
-370418,0,0,0103100000,370418,24000,번식용,2016.03
-1196438,14820,96,0105111000,1211258,4152,번식용,2016.03
-95826,0,0,0105119000,95826,3546,기타,2016.03
-10673,0,0,0105131000,10673,119,번식용,2016.03
-17000,0,0,0106110000,17000,130,영장류,2016.03
-27332,0,0,0106130000,27332,383,낙타와 그 밖의 낙타과의 동물[카멜리대(Camelidae)과],2016.03
-280984,67008,2341,0106191000,347992,3932,개,2016.03
-1952664,58740,284,0106194000,2011404,215,곰,2016.03
-610331,146430,2039,0106199000,756761,3898,기타,2016.03
-4699,0,0,0106201000,4699,28,뱀,2016.03
-80707,0,0,0106202000,80707,7426,자라,2016.03
-132841,0,0,0106203000,132841,780,거북,2016.03
-45329,1400,6,0106209000,46729,147,기타,2016.03
-62909,0,0,0106320000,62909,158,앵무류[패럿류(parrots)ㆍ패러키트류(parakeets)ㆍ금강앵무류ㆍ유황앵무류를 포함한다],2016.03
-2460,0,0,0106390000,2460,38,기타,2016.03
-98851,0,0,0106419000,98851,5557,기타,2016.03
-472,0,0,0106490000,472,17,기타,2016.03
-8537,0,0,0106901000,8537,67,양서류,2016.03
-341768,0,0,0106903010,341768,22684,갯지렁이,2016.03
-13536,0,0,0106903090,13536,8,기타,2016.03
-40996,1268,48,0106909000,42264,1770,기타,2016.03
-608275,108145,2000,0101291000,716420,13000,경주말,2016.04
-56299,0,0,0101299000,56299,3000,기타,2016.04
-526250,0,0,0103100000,526250,41618,번식용,2016.04
-26318,0,0,0105111000,26318,655,번식용,2016.04
40909,40909,170,0106122000,0,0,"물개, 바다사자와 바다코끼리(기각아목의 포유동물)",2016.04
-9905,0,0,0106149000,9905,4,기타,2016.04
-174608,53535,5659,0106191000,228143,2862,개,2016.04
-686751,36090,723,0106199000,722841,3017,기타,2016.04
-25567,0,0,0106201000,25567,65,뱀,2016.04
-58206,0,0,0106202000,58206,5443,자라,2016.04
-37005,0,0,0106203000,37005,659,거북,2016.04
-61715,0,0,0106209000,61715,138,기타,2016.04
-56988,0,0,0106320000,56988,172,앵무류[패럿류(parrots)ㆍ패러키트류(parakeets)ㆍ금강앵무류ㆍ유황앵무류를 포함한다],2016.04
-13949,0,0,0106390000,13949,80,기타,2016.04
-71453,0,0,0106419000,71453,3933,기타,2016.04
-42392,0,0,0106490000,42392,1919,기타,2016.04
-23713,3347,95,0106901000,27060,224,양서류,2016.04
-485348,0,0,0106903010,485348,31818,갯지렁이,2016.04
-10872,0,0,0106903090,10872,10,기타,2016.04
-31665,0,0,0106909000,31665,1220,기타,2016.04
-1149596,0,0,0101291000,1149596,9850,경주말,2016.05
-125337,0,0,0101299000,125337,1500,기타,2016.05
-827986,0,0,0103100000,827986,25720,번식용,2016.05
-876391,0,0,0105111000,876391,4675,번식용,2016.05
-54082,0,0,0105131000,54082,616,번식용,2016.05
-59713,0,0,0106110000,59713,192,영장류,2016.05
-162627,54870,4260,0106191000,217497,2490,개,2016.05
-651803,34872,817,0106199000,686675,3144,기타,2016.05
-8890,0,0,0106201000,8890,33,뱀,2016.05
-116857,0,0,0106202000,116857,10355,자라,2016.05
-56651,0,0,0106203000,56651,218,거북,2016.05
-51881,0,0,0106209000,51881,154,기타,2016.05
-75350,0,0,0106320000,75350,163,앵무류[패럿류(parrots)ㆍ패러키트류(parakeets)ㆍ금강앵무류ㆍ유황앵무류를 포함한다],2016.05
-9882,0,0,0106390000,9882,46,기타,2016.05
-61359,0,0,0106490000,61359,1037,기타,2016.05
-15260,8394,230,0106901000,23654,123,양서류,2016.05
-659194,0,0,0106903010,659194,43413,갯지렁이,2016.05
-466,0,0,0106903090,466,400,기타,2016.05
-26770,0,0,0106909000,26770,679,기타,2016.05
-59665,0,0,0101219000,59665,2000,기타,2016.06
-4001409,0,0,0101291000,4001409,53996,경주말,2016.06
-746554,0,0,0101299000,746554,17050,기타,2016.06
-1294665,0,0,0103100000,1294665,55000,번식용,2016.06
-24010,0,0,0103910000,24010,50,중량이 50킬로그램 미만인 것,2016.06
-489176,14820,96,0105111000,503996,3049,번식용,2016.06
-237366,0,0,0105991010,237366,270,번식용,2016.06
-310500,0,0,0106110000,310500,337,영장류,2016.06
-7000,0,0,0106121000,7000,149,"고래ㆍ돌고래ㆍ쇠돌고래(고래목의 포유동물), 매너티ㆍ듀공(바다소목의 포유동물)",2016.06
-143751,76762,2407,0106191000,220513,2701,개,2016.06
-8762,0,0,0106195090,8762,62,기타,2016.06
-688429,32680,755,0106199000,721109,4634,기타,2016.06
-11442,0,0,0106201000,11442,93,뱀,2016.06
-64570,0,0,0106202000,64570,5688,자라,2016.06
-62295,0,0,0106203000,62295,260,거북,2016.06
-49723,0,0,0106209000,49723,118,기타,2016.06
-77081,0,0,0106320000,77081,150,앵무류[패럿류(parrots)ㆍ패러키트류(parakeets)ㆍ금강앵무류ㆍ유황앵무류를 포함한다],2016.06
-4905,0,0,0106390000,4905,6,기타,2016.06
-5363,0,0,0106419000,5363,63,기타,2016.06
-32646,0,0,0106490000,32646,968,기타,2016.06
-22699,0,0,0106901000,22699,154,양서류,2016.06
-618364,0,0,0106903010,618364,42259,갯지렁이,2016.06
-378,0,0,0106903020,378,4,실지렁이,2016.06
-9987,0,0,0106903090,9987,69,기타,2016.06
-11334,0,0,0106909000,11334,383,기타,2016.06
-817574,0,0,0101291000,817574,12600,경주말,2016.07
-908219,0,0,0101299000,908219,13150,기타,2016.07
-936567,0,0,0103100000,936567,55217,번식용,2016.07
-1254481,0,0,0105111000,1254481,3296,번식용,2016.07
-18833,0,0,0105119000,18833,410,기타,2016.07
-215074,0,0,0105991010,215074,270,번식용,2016.07
-80050,0,0,0106110000,80050,100,영장류,2016.07
-8882,0,0,0106122000,8882,45,"물개, 바다사자와 바다코끼리(기각아목의 포유동물)",2016.07
-47933,0,0,0106130000,47933,1200,낙타와 그 밖의 낙타과의 동물[카멜리대(Camelidae)과],2016.07
-160595,67394,2768,0106191000,227989,2739,개,2016.07
-443,0,0,0106195090,443,3,기타,2016.07
-460124,118064,743,0106199000,578188,3517,기타,2016.07
-6795,0,0,0106201000,6795,21,뱀,2016.07
-87954,0,0,0106202000,87954,7894,자라,2016.07
-69966,0,0,0106203000,69966,354,거북,2016.07
-28761,0,0,0106209000,28761,104,기타,2016.07
-86304,0,0,0106320000,86304,180,앵무류[패럿류(parrots)ㆍ패러키트류(parakeets)ㆍ금강앵무류ㆍ유황앵무류를 포함한다],2016.07
-18018,0,0,0106390000,18018,74,기타,2016.07
-45,0,0,0106411000,45,5,꿀벌,2016.07
-30919,0,0,0106490000,30919,1532,기타,2016.07
-7881,0,0,0106901000,7881,48,양서류,2016.07
-595260,0,0,0106903010,595260,41462,갯지렁이,2016.07
-7448,0,0,0106903090,7448,64,기타,2016.07
-6299,1159,48,0106909000,7458,226,기타,2016.07
-827310,0,0,0101291000,827310,18450,경주말,2016.08
-685170,0,0,0101299000,685170,18400,기타,2016.08
-215905,0,0,0103100000,215905,13496,번식용,2016.08
-1592137,0,0,0105111000,1592137,5268,번식용,2016.08
-68984,0,0,0105119000,68984,2639,기타,2016.08
-428919,0,0,0105991010,428919,537,번식용,2016.08
-100000,0,0,0106121000,100000,400,"고래ㆍ돌고래ㆍ쇠돌고래(고래목의 포유동물), 매너티ㆍ듀공(바다소목의 포유동물)",2016.08
100,100,2,0106149000,0,0,기타,2016.08
-219507,81544,1976,0106191000,301051,2895,개,2016.08
-135000,0,0,0106195010,135000,125,번식용,2016.08
-4000,0,0,0106195090,4000,26,기타,2016.08
-678141,19301,505,0106199000,697442,3458,기타,2016.08
-13656,0,0,0106201000,13656,53,뱀,2016.08
-73050,0,0,0106202000,73050,6420,자라,2016.08
-171489,0,0,0106203000,171489,2714,거북,2016.08
-28584,0,0,0106209000,28584,120,기타,2016.08
-68815,0,0,0106320000,68815,100,앵무류[패럿류(parrots)ㆍ패러키트류(parakeets)ㆍ금강앵무류ㆍ유황앵무류를 포함한다],2016.08
-31151,0,0,0106390000,31151,80,기타,2016.08
-25227,0,0,0106490000,25227,1028,기타,2016.08
-9351,0,0,0106901000,9351,177,양서류,2016.08
-634403,0,0,0106903010,634403,43901,갯지렁이,2016.08
-9033,0,0,0106903090,9033,55,기타,2016.08
-26109,0,0,0106909000,26109,520,기타,2016.08
-500279,0,0,0101291000,500279,3000,경주말,2016.09
-273595,0,0,0101299000,273595,6700,기타,2016.09
-1504095,14820,96,0105111000,1518915,4589,번식용,2016.09
-30000,0,0,0105119000,30000,462,기타,2016.09
-341000,0,0,0106110000,341000,394,영장류,2016.09
-392,0,0,0106149000,392,2,기타,2016.09
-207502,72307,2492,0106191000,279809,2995,개,2016.09
-4433,0,0,0106195090,4433,16,기타,2016.09
-646913,32305,764,0106199000,679218,3875,기타,2016.09
-30575,0,0,0106201000,30575,1356,뱀,2016.09
-58582,0,0,0106202000,58582,5361,자라,2016.09
-49438,0,0,0106203000,49438,416,거북,2016.09
-30787,0,0,0106209000,30787,114,기타,2016.09
-101225,0,0,0106320000,101225,413,앵무류[패럿류(parrots)ㆍ패러키트류(parakeets)ㆍ금강앵무류ㆍ유황앵무류를 포함한다],2016.09
-16388,0,0,0106390000,16388,100,기타,2016.09
-94774,0,0,0106490000,94774,3064,기타,2016.09
-6780,0,0,0106901000,6780,99,양서류,2016.09
-747488,0,0,0106903010,747488,53001,갯지렁이,2016.09
-6639,0,0,0106903090,6639,5,기타,2016.09
-75626,0,0,0106909000,75626,1542,기타,2016.09
-637570,0,0,0101291000,637570,35500,경주말,2016.10
-85142,0,0,0101299000,85142,900,기타,2016.10
-902668,0,0,0102211000,902668,4850,젖소,2016.10
-347776,0,0,0103100000,347776,19310,번식용,2016.10
-327585,0,0,0105111000,327585,2056,번식용,2016.10
-120700,0,0,0106110000,120700,148,영장류,2016.10
-161713,68470,1737,0106191000,230183,2088,개,2016.10
-5586,0,0,0106195090,5586,36,기타,2016.10
-648123,33857,802,0106199000,681980,3263,기타,2016.10
-16125,0,0,0106201000,16125,142,뱀,2016.10
-83680,0,0,0106202000,83680,7809,자라,2016.10
-42046,0,0,0106203000,42046,335,거북,2016.10
-50076,0,0,0106209000,50076,137,기타,2016.10
-6547,0,0,0106310000,6547,5,맹금류,2016.10
-173509,0,0,0106320000,173509,317,앵무류[패럿류(parrots)ㆍ패러키트류(parakeets)ㆍ금강앵무류ㆍ유황앵무류를 포함한다],2016.10
-74029,0,0,0106390000,74029,87,기타,2016.10
-110187,0,0,0106490000,110187,3199,기타,2016.10
-16736,0,0,0106901000,16736,99,양서류,2016.10
-720065,0,0,0106903010,720065,47929,갯지렁이,2016.10
-2720,0,0,0106903090,2720,3,기타,2016.10
-108584,0,0,0106909000,108584,1949,기타,2016.10
-344970,0,0,0101211000,344970,13400,농가 사육용,2016.11
-19388,0,0,0101219000,19388,1400,기타,2016.11
-897347,5000,600,0101291000,902347,10425,경주말,2016.11
-263709,0,0,0101299000,263709,14075,기타,2016.11
-190697,0,0,0103100000,190697,5730,번식용,2016.11
-1203904,14820,96,0105111000,1218724,1268,번식용,2016.11
-113754,0,0,0105119000,113754,4241,기타,2016.11
-171881,0,0,0106110000,171881,160,영장류,2016.11
-163030,83875,1944,0106191000,246905,2340,개,2016.11
-100000,0,0,0106194000,100000,596,곰,2016.11
-611315,24040,554,0106199000,635355,3045,기타,2016.11
-23979,0,0,0106201000,23979,1229,뱀,2016.11
-55679,0,0,0106202000,55679,5526,자라,2016.11
-125514,0,0,0106203000,125514,233,거북,2016.11
-7178,0,0,0106209000,7178,43,기타,2016.11
-137349,0,0,0106320000,137349,324,앵무류[패럿류(parrots)ㆍ패러키트류(parakeets)ㆍ금강앵무류ㆍ유황앵무류를 포함한다],2016.11
-31066,0,0,0106390000,31066,51,기타,2016.11
-94894,0,0,0106490000,94894,4432,기타,2016.11
-26069,0,0,0106901000,26069,2126,양서류,2016.11
-539389,0,0,0106903010,539389,34798,갯지렁이,2016.11
-7398,0,0,0106903090,7398,12,기타,2016.11
-50718,0,0,0106909000,50718,1784,기타,2016.11
-2341357,0,0,0101211000,2341357,14503,농가 사육용,2016.12
-1735997,0,0,0101219000,1735997,44038,기타,2016.12
-1502483,0,0,0101291000,1502483,22806,경주말,2016.12
-732383,0,0,0101299000,732383,13485,기타,2016.12
-392672,0,0,0103100000,392672,23512,번식용,2016.12
-37380,0,0,0103910000,37380,560,중량이 50킬로그램 미만인 것,2016.12
-106800,0,0,0103920000,106800,5090,중량이 50킬로그램 이상인 것,2016.12
-661483,0,0,0105111000,661483,1838,번식용,2016.12
-279000,0,0,0106110000,279000,335,영장류,2016.12
-114566,100851,2288,0106191000,215417,2000,개,2016.12
-647801,23065,561,0106199000,670866,3464,기타,2016.12
-5498,0,0,0106201000,5498,98,뱀,2016.12
-42805,0,0,0106202000,42805,4139,자라,2016.12
-21961,0,0,0106203000,21961,197,거북,2016.12
-27211,0,0,0106209000,27211,105,기타,2016.12
-99690,0,0,0106320000,99690,197,앵무류[패럿류(parrots)ㆍ패러키트류(parakeets)ㆍ금강앵무류ㆍ유황앵무류를 포함한다],2016.12
-21648,0,0,0106390000,21648,30,기타,2016.12
-47446,0,0,0106490000,47446,1575,기타,2016.12
-71540,0,0,0106901000,71540,5909,양서류,2016.12
-293686,0,0,0106903010,293686,19391,갯지렁이,2016.12
-6280,0,0,0106903090,6280,5,기타,2016.12
-24516,0,0,0106909000,24516,361,기타,2016.12
-70278470,1666545,46070,-,71945015,1418430,-,총계
-940107,0,0,0101211000,940107,6875,농가 사육용,2017.01
-4422682,0,0,0101219000,4422682,32330,기타,2017.01
-375171,0,0,0101299000,375171,25450,기타,2017.01
-781281,0,0,0105111000,781281,3613,번식용,2017.01
-88730,0,0,0106110000,88730,214,영장류,2017.01
100,100,2,0106149000,0,0,기타,2017.01
-174254,94676,5610,0106191000,268930,2847,개,2017.01
-4745,0,0,0106195090,4745,37,기타,2017.01
-550657,23385,644,0106199000,574042,2773,기타,2017.01
-5719,0,0,0106201000,5719,21,뱀,2017.01
-34135,0,0,0106202000,34135,3010,자라,2017.01
-65139,0,0,0106203000,65139,2235,거북,2017.01
-12191,0,0,0106209000,12191,33,기타,2017.01
-52453,0,0,0106320000,52453,108,앵무류[패럿류(parrots)ㆍ패러키트류(parakeets)ㆍ금강앵무류ㆍ유황앵무류를 포함한다],2017.01
-67098,0,0,0106390000,67098,146,기타,2017.01
-109847,10,2,0106490000,109857,6524,기타,2017.01
-27320,0,0,0106901000,27320,1871,양서류,2017.01
-209527,0,0,0106903010,209527,13924,갯지렁이,2017.01
-953,0,0,0106903020,953,105,실지렁이,2017.01
-6293,0,0,0106903090,6293,5,기타,2017.01
-30518,0,0,0106909000,30518,1394,기타,2017.01
-92005,0,0,0101211000,92005,1433,농가 사육용,2017.02
-918383,5355,550,0101291000,923738,24000,경주말,2017.02
-220984,0,0,0101299000,220984,8400,기타,2017.02
-2157775,14832,96,0105111000,2172607,7530,번식용,2017.02
-264600,0,0,0106110000,264600,304,영장류,2017.02
183,183,7,0106149000,0,0,기타,2017.02
-72881,127345,3095,0106191000,200226,1757,개,2017.02
-559140,29888,713,0106199000,589028,3081,기타,2017.02
-6296,0,0,0106201000,6296,22,뱀,2017.02
-80474,0,0,0106202000,80474,7871,자라,2017.02
-47843,0,0,0106203000,47843,719,거북,2017.02
-28758,0,0,0106209000,28758,74,기타,2017.02
-20195,0,0,0106320000,20195,21,앵무류[패럿류(parrots)ㆍ패러키트류(parakeets)ㆍ금강앵무류ㆍ유황앵무류를 포함한다],2017.02
-18,0,0,0106419000,18,1,기타,2017.02
-103547,0,0,0106490000,103547,5591,기타,2017.02
-16324,0,0,0106901000,16324,24,양서류,2017.02
-221652,0,0,0106903010,221652,14753,갯지렁이,2017.02
-913,0,0,0106903020,913,80,실지렁이,2017.02
-8060,0,0,0106903090,8060,19,기타,2017.02
-52230,0,0,0106909000,52230,1613,기타,2017.02
-3204603,3769,600,0101291000,3208372,28900,경주말,2017.03
-329021,0,0,0101299000,329021,6000,기타,2017.03
-644174,0,0,0103100000,644174,46500,번식용,2017.03
136,136,2,0104209000,0,0,기타,2017.03
-54240,0,0,0105111000,54240,576,번식용,2017.03
-123850,0,0,0105119000,123850,2623,기타,2017.03
-29868,0,0,0105131000,29868,312,번식용,2017.03
-87343,0,0,0106110000,87343,6,영장류,2017.03
264,264,10,0106149000,0,0,기타,2017.03
-247712,130560,2859,0106191000,378272,2904,개,2017.03
-4000,0,0,0106195090,4000,23,기타,2017.03
-707096,28654,659,0106199000,735750,4301,기타,2017.03
-5098,1400,100,0106201000,6498,101,뱀,2017.03
-79393,0,0,0106202000,79393,6532,자라,2017.03
-53322,0,0,0106203000,53322,639,거북,2017.03
-30280,0,0,0106209000,30280,186,기타,2017.03
-107340,0,0,0106490000,107340,6059,기타,2017.03
-13566,0,0,0106901000,13566,67,양서류,2017.03
-460048,0,0,0106903010,460048,30680,갯지렁이,2017.03
-427,0,0,0106903020,427,100,실지렁이,2017.03
-12452,0,0,0106903090,12452,18,기타,2017.03
-47070,0,0,0106909000,47070,970,기타,2017.03
-30575,0,0,0101211000,30575,1680,농가 사육용,2017.04
-436400,0,0,0101219000,436400,50000,기타,2017.04
-999283,21357,600,0101291000,1020640,15790,경주말,2017.04
-121578,0,0,0101299000,121578,8180,기타,2017.04
-1262563,0,0,0103100000,1262563,87950,번식용,2017.04
45,45,1,0104209000,0,0,기타,2017.04
2340,2340,16,0105111000,0,0,번식용,2017.04
-84800,0,0,0106110000,84800,164,영장류,2017.04
-64105,0,0,0106122000,64105,120,"물개, 바다사자와 바다코끼리(기각아목의 포유동물)",2017.04
-221669,102721,2536,0106191000,324390,2654,개,2017.04
-655262,31685,790,0106199000,686947,4026,기타,2017.04
-7102,0,0,0106201000,7102,17,뱀,2017.04
-65522,0,0,0106202000,65522,5864,자라,2017.04
-81553,0,0,0106203000,81553,636,거북,2017.04
-39413,0,0,0106209000,39413,151,기타,2017.04
-59354,0,0,0106320000,59354,130,앵무류[패럿류(parrots)ㆍ패러키트류(parakeets)ㆍ금강앵무류ㆍ유황앵무류를 포함한다],2017.04
-100685,0,0,0106490000,100685,3195,기타,2017.04
-10415,2354,60,0106901000,12769,47,양서류,2017.04
-599514,0,0,0106903010,599514,40620,갯지렁이,2017.04
-6410,0,0,0106903090,6410,6,기타,2017.04
-29689,0,0,0106909000,29689,960,기타,2017.04
-519651,0,0,0101291000,519651,6200,경주말,2017.05
-68716,0,0,0101299000,68716,2500,기타,2017.05
-558659,0,0,0103100000,558659,32300,번식용,2017.05
-188480,0,0,0105111000,188480,1179,번식용,2017.05
-318000,0,0,0106110000,318000,315,영장류,2017.05
-39255,0,0,0106130000,39255,900,낙타와 그 밖의 낙타과의 동물[카멜리대(Camelidae)과],2017.05
-556,0,0,0106149000,556,80,기타,2017.05
-86518,123824,2661,0106191000,210342,1592,개,2017.05
-2726,0,0,0106195090,2726,30,기타,2017.05
-650723,30175,773,0106199000,680898,4869,기타,2017.05
-7678,0,0,0106201000,7678,69,뱀,2017.05
-66710,0,0,0106202000,66710,5661,자라,2017.05
-59938,82,2,0106203000,60020,132,거북,2017.05
-48495,0,0,0106209000,48495,150,기타,2017.05
-99881,0,0,0106320000,99881,170,앵무류[패럿류(parrots)ㆍ패러키트류(parakeets)ㆍ금강앵무류ㆍ유황앵무류를 포함한다],2017.05
-47204,0,0,0106490000,47204,1347,기타,2017.05
-10803,3495,110,0106901000,14298,95,양서류,2017.05
-809259,0,0,0106903010,809259,54605,갯지렁이,2017.05
-1300,0,0,0106903020,1300,37,실지렁이,2017.05
-916,0,0,0106903090,916,55,기타,2017.05
-19252,0,0,0106909000,19252,380,기타,2017.05
-4391132,0,0,0101291000,4391132,41586,경주말,2017.06
-2414890,0,0,0101299000,2414890,21265,기타,2017.06
-1445230,0,0,0103100000,1445230,53173,번식용,2017.06
-145522,0,0,0103920000,145522,4375,중량이 50킬로그램 이상인 것,2017.06
-557566,20880,96,0105111000,578446,2879,번식용,2017.06
-767542,0,0,0105119000,767542,16128,기타,2017.06
-118417,132248,2696,0106191000,250665,1994,개,2017.06
-624,0,0,0106195090,624,6,기타,2017.06
-772526,21671,596,0106199000,794197,4692,기타,2017.06
-8581,0,0,0106201000,8581,97,뱀,2017.06
-85613,0,0,0106202000,85613,7110,자라,2017.06
-57805,0,0,0106203000,57805,79,거북,2017.06
-55129,0,0,0106209000,55129,272,기타,2017.06
-63845,0,0,0106320000,63845,137,앵무류[패럿류(parrots)ㆍ패러키트류(parakeets)ㆍ금강앵무류ㆍ유황앵무류를 포함한다],2017.06
-28735,0,0,0106490000,28735,709,기타,2017.06
-23255,0,0,0106901000,23255,82,양서류,2017.06
-723738,0,0,0106903010,723738,49747,갯지렁이,2017.06
-10241,0,0,0106903090,10241,30,기타,2017.06
-9141,0,0,0106909000,9141,194,기타,2017.06
-2085077,87000,1200,0101291000,2172077,26102,경주말,2017.07
-1167735,0,0,0103100000,1167735,60740,번식용,2017.07
-647092,0,0,0105111000,647092,2995,번식용,2017.07
-3033538,0,0,0105119000,3033538,65280,기타,2017.07
-82540,0,0,0105131000,82540,4374,번식용,2017.07
-333918,0,0,0105139000,333918,10712,기타,2017.07
-240000,0,0,0106110000,240000,257,영장류,2017.07
-14000,0,0,0106121000,14000,490,"고래ㆍ돌고래ㆍ쇠돌고래(고래목의 포유동물), 매너티ㆍ듀공(바다소목의 포유동물)",2017.07
-13694,0,0,0106141000,13694,380,번식용,2017.07
-1066,100,3,0106149000,1166,7,기타,2017.07
-94409,116130,7489,0106191000,210539,2132,개,2017.07
-15558,0,0,0106195090,15558,53,기타,2017.07
-574000,24352,688,0106199000,598352,3625,기타,2017.07
-6380,0,0,0106201000,6380,24,뱀,2017.07
-88173,0,0,0106202000,88173,7238,자라,2017.07
-94232,0,0,0106203000,94232,210,거북,2017.07
-27349,0,0,0106209000,27349,63,기타,2017.07
-207786,0,0,0106320000,207786,437,앵무류[패럿류(parrots)ㆍ패러키트류(parakeets)ㆍ금강앵무류ㆍ유황앵무류를 포함한다],2017.07
-6794,0,0,0106390000,6794,3,기타,2017.07
-23835,0,0,0106490000,23835,628,기타,2017.07
-5106,0,0,0106901000,5106,16,양서류,2017.07
-621819,0,0,0106903010,621819,44198,갯지렁이,2017.07
-419,0,0,0106903090,419,54,기타,2017.07
-10469,0,0,0106909000,10469,236,기타,2017.07
-715434,0,0,0101291000,715434,6500,경주말,2017.08
-133429,0,0,0101299000,133429,3300,기타,2017.08
-459205,0,0,0103100000,459205,22415,번식용,2017.08
-326535,0,0,0105111000,326535,1989,번식용,2017.08
-2840604,0,0,0105119000,2840604,66489,기타,2017.08
-185107,0,0,0105131000,185107,3747,번식용,2017.08
-86867,0,0,0105139000,86867,1693,기타,2017.08
-51708,0,0,0106149000,51708,1397,기타,2017.08
-178909,120957,2089,0106191000,299866,2255,개,2017.08
-118800,0,0,0106195010,118800,77,번식용,2017.08
-765816,27858,623,0106199000,793674,5089,기타,2017.08
-5295,0,0,0106201000,5295,20,뱀,2017.08
-66380,0,0,0106202000,66380,5616,자라,2017.08
-54463,0,0,0106203000,54463,121,거북,2017.08
-25533,0,0,0106209000,25533,150,기타,2017.08
-127015,0,0,0106320000,127015,269,앵무류[패럿류(parrots)ㆍ패러키트류(parakeets)ㆍ금강앵무류ㆍ유황앵무류를 포함한다],2017.08
-1672,0,0,0106390000,1672,2,기타,2017.08
-44100,0,0,0106490000,44100,1074,기타,2017.08
-3791,0,0,0106901000,3791,48,양서류,2017.08
-710937,0,0,0106903010,710937,51135,갯지렁이,2017.08
-17057,0,0,0106903090,17057,38,기타,2017.08
-29198,0,0,0106909000,29198,539,기타,2017.08
-513105,0,0,0101211000,513105,2500,농가 사육용,2017.09
-32675,0,0,0101219000,32675,1000,기타,2017.09
-1543572,0,0,0101291000,1543572,15850,경주말,2017.09
-115810,0,0,0101299000,115810,5400,기타,2017.09
-987668,0,0,0102211000,987668,4320,젖소,2017.09
-659456,0,0,0103100000,659456,28410,번식용,2017.09
-2152031,14832,96,0105111000,2166863,7041,번식용,2017.09
-2991054,0,0,0105119000,2991054,64173,기타,2017.09
16778,34700,300,0106110000,17922,40,영장류,2017.09
-67938,0,0,0106130000,67938,1560,낙타와 그 밖의 낙타과의 동물[카멜리대(Camelidae)과],2017.09
-3819,0,0,0106149000,3819,60,기타,2017.09
-132292,102664,1768,0106191000,234956,1941,개,2017.09
22700,22700,85,0106194000,0,0,곰,2017.09
-60130,0,0,0106195090,60130,34,기타,2017.09
-507689,33083,816,0106199000,540772,4060,기타,2017.09
-57353,0,0,0106201000,57353,2158,뱀,2017.09
-70796,0,0,0106202000,70796,5726,자라,2017.09
-101277,0,0,0106203000,101277,383,거북,2017.09
-47306,932,8,0106209000,48238,201,기타,2017.09
-337707,0,0,0106320000,337707,679,앵무류[패럿류(parrots)ㆍ패러키트류(parakeets)ㆍ금강앵무류ㆍ유황앵무류를 포함한다],2017.09
-6489,0,0,0106390000,6489,31,기타,2017.09
-115900,0,0,0106490000,115900,2256,기타,2017.09
-8075,0,0,0106901000,8075,108,양서류,2017.09
-772761,0,0,0106903010,772761,54539,갯지렁이,2017.09
-2725,0,0,0106903020,2725,400,실지렁이,2017.09
-4353,0,0,0106903090,4353,19,기타,2017.09
-94509,0,0,0106909000,94509,1929,기타,2017.09
-88670,0,0,0101291000,88670,1350,경주말,2017.10
-745750,0,0,0103100000,745750,50500,번식용,2017.10
-2116218,0,0,0105111000,2116218,4048,번식용,2017.10
-929967,0,0,0105119000,929967,22343,기타,2017.10
-225832,0,0,0105991010,225832,268,번식용,2017.10
-25600,0,0,0106110000,25600,4,영장류,2017.10
-105038,0,0,0106130000,105038,2629,낙타와 그 밖의 낙타과의 동물[카멜리대(Camelidae)과],2017.10
-19224,0,0,0106149000,19224,415,기타,2017.10
-153698,92215,1297,0106191000,245913,2254,개,2017.10
-718516,26996,675,0106199000,745512,3587,기타,2017.10
-18540,0,0,0106201000,18540,1108,뱀,2017.10
-64208,0,0,0106202000,64208,5402,자라,2017.10
-72964,0,0,0106203000,72964,177,거북,2017.10
-21075,10450,1,0106209000,31525,115,기타,2017.10
-161003,0,0,0106320000,161003,330,앵무류[패럿류(parrots)ㆍ패러키트류(parakeets)ㆍ금강앵무류ㆍ유황앵무류를 포함한다],2017.10
-40673,0,0,0106390000,40673,37,기타,2017.10
-153749,0,0,0106490000,153749,2777,기타,2017.10
-14808,0,0,0106901000,14808,45,양서류,2017.10
-1023857,0,0,0106903010,1023857,71617,갯지렁이,2017.10
-688,0,0,0106903090,688,16,기타,2017.10
-112133,0,0,0106909000,112133,2090,기타,2017.10
18152,200000,1150,0101291000,181848,3000,경주말,2017.11
-385667,0,0,0101299000,385667,8500,기타,2017.11
-690264,0,0,0103100000,690264,36884,번식용,2017.11
-24836,0,0,0103920000,24836,5880,중량이 50킬로그램 이상인 것,2017.11
-2364756,0,0,0105111000,2364756,9573,번식용,2017.11
-227210,0,0,0105991010,227210,270,번식용,2017.11
-18278,0,0,0106130000,18278,630,낙타와 그 밖의 낙타과의 동물[카멜리대(Camelidae)과],2017.11
-45903,0,0,0106149000,45903,982,기타,2017.11
-53449,88723,2346,0106191000,142172,1267,개,2017.11
-38667,0,0,0106194000,38667,45,곰,2017.11
-682086,28802,619,0106199000,710888,4197,기타,2017.11
-11531,0,0,0106201000,11531,33,뱀,2017.11
-110749,0,0,0106202000,110749,6809,자라,2017.11
-18535,54,12,0106203000,18589,707,거북,2017.11
-57403,0,0,0106209000,57403,167,기타,2017.11
-336449,0,0,0106320000,336449,646,앵무류[패럿류(parrots)ㆍ패러키트류(parakeets)ㆍ금강앵무류ㆍ유황앵무류를 포함한다],2017.11
-4814,0,0,0106390000,4814,34,기타,2017.11
-12920,0,0,0106419000,12920,80,기타,2017.11
-63866,0,0,0106490000,63866,1591,기타,2017.11
-82091,0,0,0106901000,82091,3654,양서류,2017.11
-510936,1245,26,0106903010,512181,35897,갯지렁이,2017.11
-15676,0,0,0106903090,15676,23,기타,2017.11
-52516,0,0,0106909000,52516,462,기타,2017.11
-248020,0,0,0101211000,248020,5565,농가 사육용,2017.12
-3320223,0,0,0101219000,3320223,56222,기타,2017.12
-981411,0,0,0101291000,981411,14500,경주말,2017.12
-153610,0,0,0101299000,153610,5000,기타,2017.12
-348654,0,0,0103100000,348654,28700,번식용,2017.12
-62806,0,0,0103910000,62806,421,중량이 50킬로그램 미만인 것,2017.12
-538282,14832,96,0105111000,553114,2368,번식용,2017.12
-322465,0,0,0105991010,322465,373,번식용,2017.12
-1239183,0,0,0106110000,1239183,1481,영장류,2017.12
-9500,0,0,0106122000,9500,100,"물개, 바다사자와 바다코끼리(기각아목의 포유동물)",2017.12
-60493,0,0,0106130000,60493,1900,낙타와 그 밖의 낙타과의 동물[카멜리대(Camelidae)과],2017.12
-20930,0,0,0106149000,20930,489,기타,2017.12
18657,106283,5173,0106191000,87626,1081,개,2017.12
-1961,0,0,0106195090,1961,12,기타,2017.12
-522989,27215,621,0106199000,550204,3575,기타,2017.12
-15543,0,0,0106201000,15543,157,뱀,2017.12
-35324,0,0,0106202000,35324,2967,자라,2017.12
-55576,81,5,0106203000,55657,146,거북,2017.12
-51332,1362,10,0106209000,52694,264,기타,2017.12
-105962,0,0,0106320000,105962,206,앵무류[패럿류(parrots)ㆍ패러키트류(parakeets)ㆍ금강앵무류ㆍ유황앵무류를 포함한다],2017.12
-19158,0,0,0106390000,19158,3,기타,2017.12
-64230,102,3,0106490000,64332,2137,기타,2017.12
-157389,0,0,0106901000,157389,5759,양서류,2017.12
-255010,1250,26,0106903010,256260,17400,갯지렁이,2017.12
-37,0,0,0106903020,37,0,실지렁이,2017.12
-3851,0,0,0106903090,3851,13,기타,2017.12
-32475,185,2,0106909000,32660,490,기타,2017.12
-88129151,2138537,53109,-,90267688,1910514,-,총계
-594712,0,0,0101219000,594712,1500,기타,2018.01
143776,143776,600,0101291000,0,0,경주말,2018.01
-99585,0,0,0101299000,99585,3500,기타,2018.01
-444648,0,0,0105111000,444648,1181,번식용,2018.01
51219,51219,150,0106110000,0,0,영장류,2018.01
-36430,0,0,0106130000,36430,372,낙타와 그 밖의 낙타과의 동물[카멜리대(Camelidae)과],2018.01
-32702,0,0,0106149000,32702,827,기타,2018.01
-5839,121935,1432,0106191000,127774,1257,개,2018.01
-279,0,0,0106196090,279,2,기타,2018.01
-831525,33923,767,0106199000,865448,3513,기타,2018.01
-13826,0,0,0106201000,13826,38,뱀,2018.01
-57406,0,0,0106202000,57406,4709,자라,2018.01
-59240,0,0,0106203000,59240,219,거북,2018.01
-38079,0,0,0106209000,38079,139,기타,2018.01
-7111,0,0,0106310000,7111,10,맹금류,2018.01
-20148,0,0,0106320000,20148,40,앵무류[패럿류(parrots)ㆍ패러키트류(parakeets)ㆍ금강앵무류ㆍ유황앵무류를 포함한다],2018.01
-87708,0,0,0106490000,87708,3083,기타,2018.01
-69398,0,0,0106901000,69398,2893,양서류,2018.01
-217944,2447,51,0106903010,220391,15006,갯지렁이,2018.01
-69,0,0,0106903020,69,1,실지렁이,2018.01
-45,0,0,0106903090,45,5,기타,2018.01
-26535,0,0,0106909000,26535,459,기타,2018.01
-84080,0,0,0101211000,84080,1525,농가 사육용,2018.02
-133900,0,0,0101219000,133900,3000,기타,2018.02
-268174,0,0,0101291000,268174,3800,경주말,2018.02
-391120,0,0,0101299000,391120,10375,기타,2018.02
-74161,0,0,0101309000,74161,8330,기타,2018.02
-574704,0,0,0105111000,574704,1667,번식용,2018.02
-53491,181,12,0106149000,53672,1488,기타,2018.02
-313,99169,1525,0106191000,99482,883,개,2018.02
-613782,23585,550,0106199000,637367,3064,기타,2018.02
-19628,0,0,0106201000,19628,105,뱀,2018.02
-41121,0,0,0106202000,41121,3727,자라,2018.02
-60394,0,0,0106203000,60394,2100,거북,2018.02
-46292,0,0,0106209000,46292,166,기타,2018.02
-28457,0,0,0106310000,28457,30,맹금류,2018.02
-36420,0,0,0106320000,36420,62,앵무류[패럿류(parrots)ㆍ패러키트류(parakeets)ㆍ금강앵무류ㆍ유황앵무류를 포함한다],2018.02
-136331,0,0,0106390000,136331,47,기타,2018.02
-84112,0,0,0106490000,84112,3237,기타,2018.02
-17899,0,0,0106901000,17899,1083,양서류,2018.02
-250470,1252,26,0106903010,251722,17398,갯지렁이,2018.02
-54,0,0,0106903020,54,1,실지렁이,2018.02
-14108,0,0,0106903090,14108,8,기타,2018.02
-41981,0,0,0106909000,41981,652,기타,2018.02
-572784,0,0,0101219000,572784,1000,기타,2018.03
-1520669,0,0,0101291000,1520669,15750,경주말,2018.03
-837341,0,0,0101299000,837341,12500,기타,2018.03
-188776,0,0,0103920000,188776,9880,중량이 50킬로그램 이상인 것,2018.03
14832,14832,96,0105111000,0,0,번식용,2018.03
-226265,0,0,0106110000,226265,525,영장류,2018.03
-45224,0,0,0106149000,45224,1118,기타,2018.03
-118968,131188,5270,0106191000,250156,2414,개,2018.03
-844380,36729,1057,0106199000,881109,4509,기타,2018.03
-9896,0,0,0106201000,9896,116,뱀,2018.03
-59923,0,0,0106202000,59923,5276,자라,2018.03
-91652,0,0,0106203000,91652,1170,거북,2018.03
-69159,3625,7,0106209000,72784,275,기타,2018.03
-60097,81,4,0106320000,60178,43,앵무류[패럿류(parrots)ㆍ패러키트류(parakeets)ㆍ금강앵무류ㆍ유황앵무류를 포함한다],2018.03
-10207,0,0,0106390000,10207,32,기타,2018.03
-149463,0,0,0106490000,149463,7605,기타,2018.03
-8304,0,0,0106901000,8304,66,양서류,2018.03
-496909,1225,25,0106903010,498134,33546,갯지렁이,2018.03
-144,0,0,0106903020,144,2,실지렁이,2018.03
-19385,0,0,0106903090,19385,63,기타,2018.03
-61616,0,0,0106909000,61616,1354,기타,2018.03
-1604298,2074,600,0101291000,1606372,10850,경주말,2018.04
-206990,0,0,0101299000,206990,4000,기타,2018.04
-321908,0,0,0103100000,321908,11360,번식용,2018.04
-644641,0,0,0105111000,644641,3230,번식용,2018.04
-111340,0,0,0106110000,111340,8,영장류,2018.04
247500,247500,250,0106122000,0,0,"물개, 바다사자와 바다코끼리(기각아목의 포유동물)",2018.04
-33004,0,0,0106149000,33004,754,기타,2018.04
-95295,128750,1892,0106191000,224045,1859,개,2018.04
-981671,30039,588,0106199000,1011710,3999,기타,2018.04
-15275,0,0,0106201000,15275,99,뱀,2018.04
-88406,0,0,0106202000,88406,6740,자라,2018.04
-78327,0,0,0106203000,78327,369,거북,2018.04
-58417,0,0,0106209000,58417,312,기타,2018.04
-9959,0,0,0106310000,9959,22,맹금류,2018.04
-17057,0,0,0106320000,17057,22,앵무류[패럿류(parrots)ㆍ패러키트류(parakeets)ㆍ금강앵무류ㆍ유황앵무류를 포함한다],2018.04
-10021,0,0,0106390000,10021,14,기타,2018.04
-83286,0,0,0106490000,83286,1791,기타,2018.04
-7224,0,0,0106901000,7224,36,양서류,2018.04
-631524,2514,51,0106903010,634038,39921,갯지렁이,2018.04
-35,0,0,0106903090,35,1,기타,2018.04
-44968,0,0,0106909000,44968,939,기타,2018.04
-990968,0,0,0101291000,990968,9100,경주말,2018.05
-112329,0,0,0101299000,112329,1100,기타,2018.05
-1068771,0,0,0103100000,1068771,58494,번식용,2018.05
-70444,0,0,0103920000,70444,3270,중량이 50킬로그램 이상인 것,2018.05
-412080,0,0,0104201000,412080,18132,젖염소,2018.05
-611380,0,0,0104209000,611380,26809,기타,2018.05
-776996,0,0,0105111000,776996,2631,번식용,2018.05
-75049,0,0,0105131000,75049,968,번식용,2018.05
-1448250,0,0,0106110000,1448250,2083,영장류,2018.05
-56674,81,5,0106149000,56755,1339,기타,2018.05
-117742,113010,2399,0106191000,230752,2014,개,2018.05
-968,0,0,0106196090,968,6,기타,2018.05
-922695,31879,786,0106199000,954574,3833,기타,2018.05
-12842,0,0,0106201000,12842,56,뱀,2018.05
-99764,0,0,0106202000,99764,7474,자라,2018.05
-30243,0,0,0106203000,30243,590,거북,2018.05
-96197,0,0,0106209000,96197,231,기타,2018.05
-6758,0,0,0106310000,6758,3,맹금류,2018.05
-71332,0,0,0106490000,71332,1407,기타,2018.05
-13976,0,0,0106901000,13976,72,양서류,2018.05
-879243,2534,51,0106903010,881777,56469,갯지렁이,2018.05
-7106,0,0,0106903090,7106,9,기타,2018.05
-25458,0,0,0106909000,25458,523,기타,2018.05
-2623437,180632,1000,0101291000,2804069,28100,경주말,2018.06
-362711,0,0,0101299000,362711,6400,기타,2018.06
-226140,0,0,0103100000,226140,12220,번식용,2018.06
-1687124,14832,96,0105111000,1701956,5177,번식용,2018.06
-37956,0,0,0106149000,37956,893,기타,2018.06
-96348,97903,3634,0106191000,194251,1585,개,2018.06
-808281,42880,1526,0106199000,851161,4119,기타,2018.06
-24309,0,0,0106201000,24309,98,뱀,2018.06
-72329,0,0,0106202000,72329,5368,자라,2018.06
-74405,0,0,0106203000,74405,193,거북,2018.06
-103316,0,0,0106209000,103316,613,기타,2018.06
-28657,0,0,0106320000,28657,36,앵무류[패럿류(parrots)ㆍ패러키트류(parakeets)ㆍ금강앵무류ㆍ유황앵무류를 포함한다],2018.06
-57867,0,0,0106490000,57867,970,기타,2018.06
-19934,0,0,0106901000,19934,71,양서류,2018.06
-774065,4145,82,0106903010,778210,52079,갯지렁이,2018.06
-1841,0,0,0106903090,1841,165,기타,2018.06
-12146,0,0,0106909000,12146,312,기타,2018.06
-4264263,67300,1800,0101291000,4331563,50550,경주말,2018.07
-258457,0,0,0103100000,258457,10460,번식용,2018.07
-1047433,0,0,0105111000,1047433,2393,번식용,2018.07
-298330,0,0,0105131000,298330,324,번식용,2018.07
-61650,0,0,0106110000,61650,75,영장류,2018.07
-57402,91,5,0106149000,57493,1352,기타,2018.07
-15989,82614,1420,0106191000,98603,1031,개,2018.07
-10548,0,0,0106195090,10548,17,기타,2018.07
-766434,21582,526,0106199000,788016,4141,기타,2018.07
-17153,0,0,0106201000,17153,710,뱀,2018.07
-76893,0,0,0106202000,76893,5955,자라,2018.07
-86274,0,0,0106203000,86274,637,거북,2018.07
-61916,2190,4,0106209000,64106,134,기타,2018.07
-85613,0,0,0106320000,85613,129,앵무류[패럿류(parrots)ㆍ패러키트류(parakeets)ㆍ금강앵무류ㆍ유황앵무류를 포함한다],2018.07
-2919,0,0,0106390000,2919,4,기타,2018.07
-28,0,0,0106419000,28,2,기타,2018.07
-45340,0,0,0106490000,45340,1053,기타,2018.07
-27193,0,0,0106901000,27193,34,양서류,2018.07
-678182,2757,54,0106903010,680939,47844,갯지렁이,2018.07
-685,0,0,0106903020,685,3,실지렁이,2018.07
-12742,0,0,0106903090,12742,15,기타,2018.07
-16329,0,0,0106909000,16329,465,기타,2018.07
139905,139905,4800,0101291000,0,0,경주말,2018.08
-521919,14832,96,0105111000,536751,3746,번식용,2018.08
-247571,0,0,0105131000,247571,270,번식용,2018.08
-1219800,0,0,0106110000,1219800,2751,영장류,2018.08
-48044,0,0,0106149000,48044,1079,기타,2018.08
-130561,86578,1753,0106191000,217139,1916,개,2018.08
-120000,0,0,0106195010,120000,80,번식용,2018.08
-530183,10046,334,0106199000,540229,2744,기타,2018.08
-14692,0,0,0106201000,14692,16,뱀,2018.08
-54978,0,0,0106202000,54978,4287,자라,2018.08
-75511,0,0,0106203000,75511,144,거북,2018.08
-56406,0,0,0106209000,56406,187,기타,2018.08
-122007,0,0,0106320000,122007,232,앵무류[패럿류(parrots)ㆍ패러키트류(parakeets)ㆍ금강앵무류ㆍ유황앵무류를 포함한다],2018.08
-3155,0,0,0106390000,3155,10,기타,2018.08
-33188,0,0,0106490000,33188,1152,기타,2018.08
-4250,0,0,0106901000,4250,33,양서류,2018.08
-715604,1152,23,0106903010,716756,51010,갯지렁이,2018.08
-4143,0,0,0106903090,4143,836,기타,2018.08
-29719,0,0,0106909000,29719,586,기타,2018.08
-1538783,0,0,0101291000,1538783,10600,경주말,2018.09
-843480,0,0,0101299000,843480,74000,기타,2018.09
-959914,0,0,0102211000,959914,6416,젖소,2018.09
-276170,0,0,0103100000,276170,8328,번식용,2018.09
-243057,0,0,0105131000,243057,270,번식용,2018.09
-48059,0,0,0106149000,48059,1128,기타,2018.09
-113087,121690,1024,0106191000,234777,1933,개,2018.09
-716117,14988,386,0106199000,731105,3304,기타,2018.09
-41788,0,0,0106201000,41788,95,뱀,2018.09
-42629,0,0,0106202000,42629,3324,자라,2018.09
-75338,0,0,0106203000,75338,264,거북,2018.09
-134281,0,0,0106209000,134281,307,기타,2018.09
-152185,0,0,0106320000,152185,543,앵무류[패럿류(parrots)ㆍ패러키트류(parakeets)ㆍ금강앵무류ㆍ유황앵무류를 포함한다],2018.09
-118663,0,0,0106490000,118663,3472,기타,2018.09
-17552,0,0,0106901000,17552,99,양서류,2018.09
-945727,0,0,0106903010,945727,65648,갯지렁이,2018.09
-919,0,0,0106903020,919,37,실지렁이,2018.09
-12967,0,0,0106903090,12967,12,기타,2018.09
-91667,0,0,0106909000,91667,1635,기타,2018.09
-275774,181414,3000,0101291000,457188,6550,경주말,2018.10
-749178,0,0,0103100000,749178,33475,번식용,2018.10
-76162,0,0,0103920000,76162,3800,중량이 50킬로그램 이상인 것,2018.10
-1816737,14832,96,0105111000,1831569,3092,번식용,2018.10
-213142,0,0,0105131000,213142,1136,번식용,2018.10
-153200,0,0,0106110000,153200,102,영장류,2018.10
-6922,0,0,0106122000,6922,105,"물개, 바다사자와 바다코끼리(기각아목의 포유동물)",2018.10
-23147,0,0,0106130000,23147,480,낙타와 그 밖의 낙타과의 동물[카멜리대(Camelidae)과],2018.10
-55575,0,0,0106149000,55575,1538,기타,2018.10
-69004,152347,5380,0106191000,221351,2106,개,2018.10
-80000,0,0,0106194000,80000,381,곰,2018.10
-852846,33317,814,0106199000,886163,3749,기타,2018.10
-96917,0,0,0106201000,96917,3196,뱀,2018.10
-85435,0,0,0106202000,85435,6475,자라,2018.10
-60883,0,0,0106203000,60883,520,거북,2018.10
-90549,0,0,0106209000,90549,320,기타,2018.10
-167591,0,0,0106320000,167591,252,앵무류[패럿류(parrots)ㆍ패러키트류(parakeets)ㆍ금강앵무류ㆍ유황앵무류를 포함한다],2018.10
-11018,0,0,0106390000,11018,20,기타,2018.10
-195924,0,0,0106490000,195924,3121,기타,2018.10
-62033,0,0,0106901000,62033,1472,양서류,2018.10
-887985,0,0,0106903010,887985,61498,갯지렁이,2018.10
-8572,0,0,0106903090,8572,11,기타,2018.10
-158017,0,0,0106909000,158017,2349,기타,2018.10
-1909112,0,0,0101291000,1909112,29450,경주말,2018.11
-763110,0,0,0103100000,763110,23153,번식용,2018.11
-23900,0,0,0103910000,23900,540,중량이 50킬로그램 미만인 것,2018.11
-1094346,0,0,0105111000,1094346,4557,번식용,2018.11
-1314325,0,0,0106110000,1314325,1381,영장류,2018.11
-27500,0,0,0106122000,27500,35,"물개, 바다사자와 바다코끼리(기각아목의 포유동물)",2018.11
-42715,0,0,0106149000,42715,1077,기타,2018.11
-62102,114719,1950,0106191000,176821,1885,개,2018.11
-842832,25192,501,0106199000,868024,4053,기타,2018.11
-28587,0,0,0106201000,28587,90,뱀,2018.11
-47829,0,0,0106202000,47829,3854,자라,2018.11
-76381,270,113,0106203000,76651,102,거북,2018.11
-104776,0,0,0106209000,104776,194,기타,2018.11
-154506,0,0,0106320000,154506,361,앵무류[패럿류(parrots)ㆍ패러키트류(parakeets)ㆍ금강앵무류ㆍ유황앵무류를 포함한다],2018.11
-56712,0,0,0106390000,56712,49,기타,2018.11
-7,0,0,0106411000,7,2,꿀벌,2018.11
-83012,0,0,0106490000,83012,1941,기타,2018.11
-87193,0,0,0106901000,87193,4400,양서류,2018.11
-679016,0,0,0106903010,679016,47754,갯지렁이,2018.11
-5371,0,0,0106903090,5371,6,기타,2018.11
-81594,0,0,0106909000,81594,938,기타,2018.11
-418353,0,0,0101211000,418353,10506,농가 사육용,2018.12
-1366258,0,0,0101219000,1366258,25833,기타,2018.12
-1109422,214700,2000,0101291000,1324122,21111,경주말,2018.12
-230457,0,0,0101299000,230457,4800,기타,2018.12
-68254,0,0,0103100000,68254,2700,번식용,2018.12
-2435221,6798,46,0105111000,2442019,7233,번식용,2018.12
200,200,25,0105119000,0,0,기타,2018.12
-237023,0,0,0105131000,237023,908,번식용,2018.12
-8850,0,0,0106110000,8850,10,영장류,2018.12
-90913,0,0,0106130000,90913,1900,낙타와 그 밖의 낙타과의 동물[카멜리대(Camelidae)과],2018.12
-30495,0,0,0106149000,30495,792,기타,2018.12
-432055,119700,1423,0106191000,551755,2796,개,2018.12
-874368,25104,586,0106199000,899472,3217,기타,2018.12
-14582,0,0,0106201000,14582,116,뱀,2018.12
-52300,0,0,0106202000,52300,4149,자라,2018.12
-41102,0,0,0106203000,41102,205,거북,2018.12
-148271,0,0,0106209000,148271,391,기타,2018.12
-106932,0,0,0106320000,106932,260,앵무류[패럿류(parrots)ㆍ패러키트류(parakeets)ㆍ금강앵무류ㆍ유황앵무류를 포함한다],2018.12
31612,169714,125,0106390000,138102,337,기타,2018.12
-50378,0,0,0106490000,50378,1258,기타,2018.12
-178997,0,0,0106901000,178997,10704,양서류,2018.12
-312039,0,0,0106903010,312039,21799,갯지렁이,2018.12
-3886,0,0,0106903090,3886,9,기타,2018.12
-29443,0,0,0106909000,29443,292,기타,2018.12
-70455139,3187972,52812,-,73643111,1362795,-,총계
-527134,0,0,0105111000,527134,2187,번식용,2019.01
-22453,0,0,0106149000,22453,566,기타,2019.01
-198496,126944,1411,0106191000,325440,2835,개,2019.01
-816978,28440,713,0106199000,845418,3330,기타,2019.01
-30346,0,0,0106201000,30346,546,뱀,2019.01
-42360,0,0,0106202000,42360,3386,자라,2019.01
-84893,0,0,0106203000,84893,2018,거북,2019.01
-64537,0,0,0106209000,64537,259,기타,2019.01
-7075,0,0,0106390000,7075,14,기타,2019.01
-118244,0,0,0106490000,118244,2396,기타,2019.01
-123389,0,0,0106901000,123389,7551,양서류,2019.01
-342445,0,0,0106903010,342445,24171,갯지렁이,2019.01
-2465,0,0,0106903090,2465,10,기타,2019.01
-34530,0,0,0106909000,34530,612,기타,2019.01
-1355890,0,0,0101291000,1355890,12850,경주말,2019.02
-153224,0,0,0101299000,153224,3300,기타,2019.02
27120,27120,181,0105111000,0,0,번식용,2019.02
-6796,0,0,0106110000,6796,3,영장류,2019.02
-23182,0,0,0106149000,23182,564,기타,2019.02
-124966,158336,3263,0106191000,283302,2419,개,2019.02
-2746,0,0,0106195090,2746,80,기타,2019.02
-647585,43353,559,0106199000,690938,2631,기타,2019.02
-9021,0,0,0106201000,9021,16,뱀,2019.02
-81618,0,0,0106202000,81618,6829,자라,2019.02
-34226,0,0,0106203000,34226,559,거북,2019.02
-48658,2000,1,0106209000,50658,169,기타,2019.02
-90518,0,0,0106320000,90518,110,앵무류[패럿류(parrots)ㆍ패러키트류(parakeets)ㆍ금강앵무류ㆍ유황앵무류를 포함한다],2019.02
-4089,0,0,0106390000,4089,48,기타,2019.02
-119679,0,0,0106490000,119679,4500,기타,2019.02
-43529,0,0,0106901000,43529,1519,양서류,2019.02
-379979,0,0,0106903010,379979,26581,갯지렁이,2019.02
-29,0,0,0106903020,29,1,실지렁이,2019.02
-20632,0,0,0106903090,20632,18,기타,2019.02
-61548,0,0,0106909000,61548,1102,기타,2019.02
-291849,0,0,0101291000,291849,5875,경주말,2019.03
-225485,0,0,0101299000,225485,2625,기타,2019.03
-764344,0,0,0105111000,764344,1854,번식용,2019.03
-44650,0,0,0105131000,44650,522,번식용,2019.03
-33964,0,0,0106149000,33964,682,기타,2019.03
-155284,126655,1682,0106191000,281939,2159,개,2019.03
-762437,26065,635,0106199000,788502,2958,기타,2019.03
-19398,0,0,0106201000,19398,111,뱀,2019.03
-50506,0,0,0106202000,50506,4054,자라,2019.03
-93728,0,0,0106203000,93728,506,거북,2019.03
-126309,2400,3,0106209000,128709,384,기타,2019.03
200,200,100,0106310000,0,0,맹금류,2019.03
-87969,0,0,0106320000,87969,212,앵무류[패럿류(parrots)ㆍ패러키트류(parakeets)ㆍ금강앵무류ㆍ유황앵무류를 포함한다],2019.03
-49245,0,0,0106390000,49245,14,기타,2019.03
-143915,0,0,0106490000,143915,7502,기타,2019.03
-40888,0,0,0106901000,40888,2041,양서류,2019.03
-509995,0,0,0106903010,509995,34768,갯지렁이,2019.03
-2803,0,0,0106903090,2803,333,기타,2019.03
-59336,0,0,0106909000,59336,1417,기타,2019.03
-5437,0,0,0101219000,5437,450,기타,2019.04
-2557877,367926,800,0101291000,2925803,26600,경주말,2019.04
-59291,0,0,0101299000,59291,1500,기타,2019.04
-55843,0,0,0103920000,55843,2500,중량이 50킬로그램 이상인 것,2019.04
-336734,14832,96,0105111000,351566,2058,번식용,2019.04
-1886525,0,0,0106110000,1886525,1469,영장류,2019.04
-53933,0,0,0106149000,53933,882,기타,2019.04
-202369,136266,1640,0106191000,338635,2754,개,2019.04
-1683,0,0,0106195090,1683,30,기타,2019.04
-1144635,26642,671,0106199000,1171277,4100,기타,2019.04
-21490,0,0,0106201000,21490,628,뱀,2019.04
-81833,0,0,0106202000,81833,6447,자라,2019.04
-51173,0,0,0106203000,51173,333,거북,2019.04
-83696,0,0,0106209000,83696,177,기타,2019.04
-86116,0,0,0106320000,86116,253,앵무류[패럿류(parrots)ㆍ패러키트류(parakeets)ㆍ금강앵무류ㆍ유황앵무류를 포함한다],2019.04
-132966,0,0,0106490000,132966,3957,기타,2019.04
-13702,0,0,0106901000,13702,85,양서류,2019.04
-660350,0,0,0106903010,660350,44964,갯지렁이,2019.04
-4706,0,0,0106903090,4706,86,기타,2019.04
-60662,0,0,0106909000,60662,1199,기타,2019.04
-1589788,0,0,0101291000,1589788,19700,경주말,2019.05
-592909,0,0,0103100000,592909,32991,번식용,2019.05
-907186,0,0,0105111000,907186,3595,번식용,2019.05
50,50,4,0105119000,0,0,기타,2019.05
-331332,0,0,0105131000,331332,1021,번식용,2019.05
-47863,0,0,0106130000,47863,1680,낙타와 그 밖의 낙타과의 동물[카멜리대(Camelidae)과],2019.05
-76334,0,0,0106149000,76334,1951,기타,2019.05
-32084,171851,2144,0106191000,203935,2068,개,2019.05
-736414,26728,643,0106199000,763142,3125,기타,2019.05
-28733,0,0,0106201000,28733,704,뱀,2019.05
-51061,0,0,0106202000,51061,3707,자라,2019.05
-47623,0,0,0106203000,47623,319,거북,2019.05
-137631,5027,3,0106209000,142658,354,기타,2019.05
-41700,0,0,0106320000,41700,90,앵무류[패럿류(parrots)ㆍ패러키트류(parakeets)ㆍ금강앵무류ㆍ유황앵무류를 포함한다],2019.05
14251,40500,30,0106390000,26249,20,기타,2019.05
-54500,0,0,0106490000,54500,1215,기타,2019.05
-32237,0,0,0106901000,32237,86,양서류,2019.05
-849907,0,0,0106903010,849907,60242,갯지렁이,2019.05
-2771,0,0,0106903090,2771,142,기타,2019.05
-14085,0,0,0106909000,14085,266,기타,2019.05
-2606820,0,0,0101291000,2606820,24000,경주말,2019.06
-21488,0,0,0101299000,21488,1500,기타,2019.06
-340201,0,0,0103100000,340201,20203,번식용,2019.06
-51304,0,0,0103920000,51304,3800,중량이 50킬로그램 이상인 것,2019.06
-587012,0,0,0105111000,587012,2812,번식용,2019.06
-25467,0,0,0105131000,25467,258,번식용,2019.06
-41000,0,0,0106110000,41000,40,영장류,2019.06
-32539,0,0,0106130000,32539,525,낙타와 그 밖의 낙타과의 동물[카멜리대(Camelidae)과],2019.06
-77904,0,0,0106149000,77904,2177,기타,2019.06
-1737,142947,2117,0106191000,144684,1830,개,2019.06
-928217,22609,549,0106199000,950826,2910,기타,2019.06
-24243,0,0,0106201000,24243,52,뱀,2019.06
-48270,0,0,0106202000,48270,3581,자라,2019.06
-62012,0,0,0106203000,62012,329,거북,2019.06
-89251,0,0,0106209000,89251,291,기타,2019.06
-5030,0,0,0106390000,5030,20,기타,2019.06
-49533,0,0,0106490000,49533,984,기타,2019.06
-7860,0,0,0106901000,7860,72,양서류,2019.06
-674736,0,0,0106903010,674736,48225,갯지렁이,2019.06
-7,0,0,0106903020,7,4,실지렁이,2019.06
-7770,0,0,0106903090,7770,14,기타,2019.06
-13079,0,0,0106909000,13079,299,기타,2019.06
-4555417,0,0,0101291000,4555417,48498,경주말,2019.07
-123554,0,0,0101299000,123554,2730,기타,2019.07
-2123536,26520,177,0105111000,2150056,5291,번식용,2019.07
-218946,0,0,0105131000,218946,270,번식용,2019.07
-27809,0,0,0106130000,27809,240,낙타와 그 밖의 낙타과의 동물[카멜리대(Camelidae)과],2019.07
-82386,0,0,0106149000,82386,2226,기타,2019.07
-9252,125067,1704,0106191000,134319,1775,개,2019.07
-7000,0,0,0106195090,7000,14,기타,2019.07
-711654,17773,446,0106199000,729427,2821,기타,2019.07
-29284,0,0,0106201000,29284,69,뱀,2019.07
-88696,0,0,0106202000,88696,6619,자라,2019.07
-79301,0,0,0106203000,79301,349,거북,2019.07
-78184,0,0,0106209000,78184,155,기타,2019.07
-242980,0,0,0106320000,242980,414,앵무류[패럿류(parrots)ㆍ패러키트류(parakeets)ㆍ금강앵무류ㆍ유황앵무류를 포함한다],2019.07
-35642,0,0,0106390000,35642,31,기타,2019.07
-22,0,0,0106419000,22,1,기타,2019.07
-54245,0,0,0106490000,54245,979,기타,2019.07
-22765,0,0,0106901000,22765,63,양서류,2019.07
-702455,0,0,0106903010,702455,51168,갯지렁이,2019.07
-645,0,0,0106903020,645,4,실지렁이,2019.07
-5325,0,0,0106903090,5325,9,기타,2019.07
-4877,0,0,0106909000,4877,182,기타,2019.07
-458845,0,0,0101291000,458845,3500,경주말,2019.08
-37377,0,0,0101299000,37377,500,기타,2019.08
-400000,0,0,0105111000,400000,705,번식용,2019.08
-329898,0,0,0105131000,329898,404,번식용,2019.08
-746500,0,0,0106110000,746500,599,영장류,2019.08
-29490,0,0,0106130000,29490,750,낙타와 그 밖의 낙타과의 동물[카멜리대(Camelidae)과],2019.08
-68803,0,0,0106149000,68803,1983,기타,2019.08
-17271,134466,1922,0106191000,151737,1743,개,2019.08
-12147,0,0,0106195090,12147,30,기타,2019.08
-768534,20376,457,0106199000,788910,2452,기타,2019.08
-27710,0,0,0106201000,27710,40,뱀,2019.08
-55346,0,0,0106202000,55346,4205,자라,2019.08
-109003,0,0,0106203000,109003,374,거북,2019.08
-42050,0,0,0106209000,42050,140,기타,2019.08
-67448,0,0,0106320000,67448,192,앵무류[패럿류(parrots)ㆍ패러키트류(parakeets)ㆍ금강앵무류ㆍ유황앵무류를 포함한다],2019.08
-117777,0,0,0106390000,117777,18,기타,2019.08
-35322,0,0,0106490000,35322,1419,기타,2019.08
-3288,0,0,0106901000,3288,26,양서류,2019.08
-825352,0,0,0106903010,825352,58610,갯지렁이,2019.08
-6125,0,0,0106903090,6125,15,기타,2019.08
-25996,0,0,0106909000,25996,533,기타,2019.08
-7359,0,0,0101211000,7359,500,농가 사육용,2019.09
-33715,200000,550,0101291000,233715,4000,경주말,2019.09
-19535,0,0,0101299000,19535,1000,기타,2019.09
-851355,0,0,0102211000,851355,4344,젖소,2019.09
-381693,0,0,0103100000,381693,14422,번식용,2019.09
-46059,0,0,0103920000,46059,2200,중량이 50킬로그램 이상인 것,2019.09
-1135937,0,0,0105111000,1135937,3248,번식용,2019.09
165810,165810,253,0106110000,0,0,영장류,2019.09
70000,70000,120,0106122000,0,0,"물개, 바다사자와 바다코끼리(기각아목의 포유동물)",2019.09
-89409,0,0,0106149000,89409,2263,기타,2019.09
78163,141343,3142,0106191000,63180,915,개,2019.09
-897018,27680,606,0106199000,924698,3611,기타,2019.09
-55591,0,0,0106201000,55591,1047,뱀,2019.09
-29195,0,0,0106202000,29195,2310,자라,2019.09
-37687,0,0,0106203000,37687,77,거북,2019.09
-86524,0,0,0106209000,86524,547,기타,2019.09
-27639,0,0,0106320000,27639,18,앵무류[패럿류(parrots)ㆍ패러키트류(parakeets)ㆍ금강앵무류ㆍ유황앵무류를 포함한다],2019.09
-50380,0,0,0106390000,50380,62,기타,2019.09
-181161,0,0,0106490000,181161,5379,기타,2019.09
-5419,0,0,0106901000,5419,37,양서류,2019.09
-672262,0,0,0106903010,672262,47733,갯지렁이,2019.09
-9903,0,0,0106903090,9903,6,기타,2019.09
-141842,0,0,0106909000,141842,2652,기타,2019.09
2338763,2916335,1000,0101291000,577572,5850,경주말,2019.10
-106295,0,0,0101299000,106295,3000,기타,2019.10
-330290,0,0,0103100000,330290,9460,번식용,2019.10
-48438,0,0,0103910000,48438,260,중량이 50킬로그램 미만인 것,2019.10
-308852,0,0,0105111000,308852,1859,번식용,2019.10
-217987,0,0,0105131000,217987,270,번식용,2019.10
-1072400,0,0,0106110000,1072400,624,영장류,2019.10
-81513,0,0,0106149000,81513,2251,기타,2019.10
62512,172751,1768,0106191000,110239,1169,개,2019.10
-820420,21619,510,0106199000,842039,3081,기타,2019.10
-47570,0,0,0106201000,47570,1325,뱀,2019.10
-77760,0,0,0106202000,77760,6118,자라,2019.10
-69204,0,0,0106203000,69204,251,거북,2019.10
-67994,0,0,0106209000,67994,85,기타,2019.10
-103969,0,0,0106320000,103969,212,앵무류[패럿류(parrots)ㆍ패러키트류(parakeets)ㆍ금강앵무류ㆍ유황앵무류를 포함한다],2019.10
-155267,0,0,0106490000,155267,2212,기타,2019.10
-22978,0,0,0106901000,22978,68,양서류,2019.10
-849208,0,0,0106903010,849208,61866,갯지렁이,2019.10
-2687,0,0,0106903090,2687,12,기타,2019.10
-159663,0,0,0106909000,159663,2129,기타,2019.10
-16534,0,0,0101211000,16534,1500,농가 사육용,2019.11
-1440002,0,0,0101291000,1440002,13500,경주말,2019.11
-202950,0,0,0103100000,202950,13500,번식용,2019.11
-1060323,15360,136,0105111000,1075683,2251,번식용,2019.11
-46564,0,0,0106130000,46564,1330,낙타와 그 밖의 낙타과의 동물[카멜리대(Camelidae)과],2019.11
-68819,0,0,0106149000,68819,1722,기타,2019.11
-24835,154222,1378,0106191000,179057,1777,개,2019.11
-861439,34136,687,0106199000,895575,2814,기타,2019.11
-34486,0,0,0106201000,34486,96,뱀,2019.11
-48000,0,0,0106202000,48000,3927,자라,2019.11
-51537,0,0,0106203000,51537,309,거북,2019.11
-49962,0,0,0106209000,49962,176,기타,2019.11
-81527,0,0,0106320000,81527,196,앵무류[패럿류(parrots)ㆍ패러키트류(parakeets)ㆍ금강앵무류ㆍ유황앵무류를 포함한다],2019.11
-20480,0,0,0106390000,20480,20,기타,2019.11
-90985,0,0,0106490000,90985,3308,기타,2019.11
-223477,0,0,0106901000,223477,12950,양서류,2019.11
-545383,0,0,0106903010,545383,39891,갯지렁이,2019.11
-8766,0,0,0106903090,8766,9,기타,2019.11
-146558,0,0,0106909000,146558,2237,기타,2019.11
-119165,0,0,0101211000,119165,3254,농가 사육용,2019.12
-3511425,0,0,0101219000,3511425,28607,기타,2019.12
-1782054,288835,3435,0101291000,2070889,28690,경주말,2019.12
-148686,0,0,0101299000,148686,10250,기타,2019.12
-2475640,0,0,0105111000,2475640,5407,번식용,2019.12
-78809,0,0,0106130000,78809,1560,낙타와 그 밖의 낙타과의 동물[카멜리대(Camelidae)과],2019.12
-88399,0,0,0106149000,88399,2145,기타,2019.12
-94606,197412,1640,0106191000,292018,2780,개,2019.12
-33600,0,0,0106194000,33600,146,곰,2019.12
-636324,26715,517,0106199000,663039,1951,기타,2019.12
-53671,0,0,0106201000,53671,224,뱀,2019.12
-49196,0,0,0106202000,49196,4401,자라,2019.12
-52365,33,1,0106203000,52398,230,거북,2019.12
-76451,0,0,0106209000,76451,375,기타,2019.12
-87186,0,0,0106320000,87186,163,앵무류[패럿류(parrots)ㆍ패러키트류(parakeets)ㆍ금강앵무류ㆍ유황앵무류를 포함한다],2019.12
-58523,0,0,0106490000,58523,1673,기타,2019.12
-120550,0,0,0106901000,120550,8144,양서류,2019.12
-303520,0,0,0106903010,303520,22693,갯지렁이,2019.12
-11306,0,0,0106903090,11306,17,기타,2019.12
-72860,0,0,0106909000,72860,841,기타,2019.12
-62666553,6253344,37691,-,68919897,1154548,-,총계
-109406,0,0,0101211000,109406,1800,농가 사육용,2020.01
-387335,0,0,0101291000,387335,7000,경주말,2020.01
-213410,0,0,0101299000,213410,3300,기타,2020.01
-77585,0,0,0101309000,77585,8500,기타,2020.01
-1354586,0,0,0105111000,1354586,3832,번식용,2020.01
-285000,0,0,0106110000,285000,1390,영장류,2020.01
-61062,183,2,0106149000,61245,1689,기타,2020.01
-115248,176735,1233,0106191000,291983,2044,개,2020.01
-784402,13107,309,0106199000,797509,2315,기타,2020.01
-9842,0,0,0106201000,9842,22,뱀,2020.01
-51043,0,0,0106202000,51043,4511,자라,2020.01
-54850,0,0,0106203000,54850,407,거북,2020.01
-28529,0,0,0106209000,28529,104,기타,2020.01
-30299,0,0,0106320000,30299,47,앵무류[패럿류(parrots)ㆍ패러키트류(parakeets)ㆍ금강앵무류ㆍ유황앵무류를 포함한다],2020.01
-65375,0,0,0106490000,65375,3245,기타,2020.01
-175371,0,0,0106901000,175371,11489,양서류,2020.01
-294909,0,0,0106903010,294909,21899,갯지렁이,2020.01
-55,0,0,0106903090,55,3,기타,2020.01
-47401,0,0,0106909000,47401,796,기타,2020.01
-589623,60601,1200,0101291000,650224,6300,경주말,2020.02
-151233,85000,1045,0101299000,236233,3900,기타,2020.02
27000,27000,203,0105111000,0,0,번식용,2020.02
-232533,0,0,0105131000,232533,270,번식용,2020.02
-8831,0,0,0106110000,8831,7,영장류,2020.02
-72360,0,0,0106149000,72360,1976,기타,2020.02
52408,196968,2425,0106191000,144560,1567,개,2020.02
-750525,26512,726,0106199000,777037,2864,기타,2020.02
-18467,183,5,0106201000,18650,15,뱀,2020.02
-58139,0,0,0106202000,58139,4936,자라,2020.02
-35453,0,0,0106203000,35453,71,거북,2020.02
-13098,0,0,0106209000,13098,41,기타,2020.02
-82142,0,0,0106320000,82142,82,앵무류[패럿류(parrots)ㆍ패러키트류(parakeets)ㆍ금강앵무류ㆍ유황앵무류를 포함한다],2020.02
-18337,0,0,0106390000,18337,16,기타,2020.02
-80644,0,0,0106490000,80644,4036,기타,2020.02
-17695,0,0,0106901000,17695,19,양서류,2020.02
-298707,1349,29,0106903010,300056,23668,갯지렁이,2020.02
-17674,0,0,0106903090,17674,25,기타,2020.02
-63956,0,0,0106909000,63956,2222,기타,2020.02
-3182379,0,0,0101219000,3182379,3500,기타,2020.03
-1169596,0,0,0101291000,1169596,8700,경주말,2020.03
-402972,0,0,0101299000,402972,7500,기타,2020.03
-462504,0,0,0105111000,462504,2635,번식용,2020.03
-863431,0,0,0106110000,863431,822,영장류,2020.03
-77205,0,0,0106149000,77205,1976,기타,2020.03
-234783,143336,1307,0106191000,378119,2786,개,2020.03
-727429,21543,522,0106199000,748972,3250,기타,2020.03
-22965,0,0,0106202000,22965,1935,자라,2020.03
-41607,0,0,0106203000,41607,97,거북,2020.03
-51595,15670,1,0106209000,67265,189,기타,2020.03
-19436,0,0,0106320000,19436,15,앵무류[패럿류(parrots)ㆍ패러키트류(parakeets)ㆍ금강앵무류ㆍ유황앵무류를 포함한다],2020.03
-21439,0,0,0106390000,21439,6,기타,2020.03
-136069,0,0,0106490000,136069,5270,기타,2020.03
-15541,0,0,0106901000,15541,26,양서류,2020.03
-527906,0,0,0106903010,527906,41665,갯지렁이,2020.03
-3620,0,0,0106903090,3620,6,기타,2020.03
-72240,0,0,0106909000,72240,2752,기타,2020.03
-1107827,0,0,0101219000,1107827,1000,기타,2020.04
-616247,0,0,0101291000,616247,6200,경주말,2020.04
-5430,0,0,0101299000,5430,500,기타,2020.04
-1405,0,0,0101900000,1405,26,기타,2020.04
-180524,0,0,0103100000,180524,14875,번식용,2020.04
-1276612,0,0,0105111000,1276612,3616,번식용,2020.04
-32046,0,0,0106149000,32046,1072,기타,2020.04
-463558,104727,1050,0106191000,568285,3619,개,2020.04
-1000007,14786,390,0106199000,1014793,3305,기타,2020.04
-1470,0,0,0106201000,1470,3,뱀,2020.04
-57642,0,0,0106202000,57642,4886,자라,2020.04
-25233,0,0,0106203000,25233,70,거북,2020.04
-61546,0,0,0106209000,61546,98,기타,2020.04
-24509,0,0,0106320000,24509,14,앵무류[패럿류(parrots)ㆍ패러키트류(parakeets)ㆍ금강앵무류ㆍ유황앵무류를 포함한다],2020.04
-1281,0,0,0106390000,1281,4,기타,2020.04
-26,0,0,0106419000,26,1,기타,2020.04
-81091,0,0,0106490000,81091,1421,기타,2020.04
-10073,0,0,0106901000,10073,12,양서류,2020.04
-698044,0,0,0106903010,698044,53441,갯지렁이,2020.04
-3508,0,0,0106903090,3508,332,기타,2020.04
-47200,0,0,0106909000,47200,694,기타,2020.04
-2523463,0,0,0101291000,2523463,28050,경주말,2020.05
-1118675,0,0,0105111000,1118675,5093,번식용,2020.05
-129628,0,0,0106149000,129628,1588,기타,2020.05
-151697,184644,2050,0106191000,336341,2541,개,2020.05
-1099983,900,26,0106199000,1100883,4941,기타,2020.05
-56019,0,0,0106202000,56019,4627,자라,2020.05
-58562,0,0,0106203000,58562,122,거북,2020.05
-21561,9067,2,0106209000,30628,98,기타,2020.05
84,84,1,0106320000,0,0,앵무류[패럿류(parrots)ㆍ패러키트류(parakeets)ㆍ금강앵무류ㆍ유황앵무류를 포함한다],2020.05
-81538,0,0,0106490000,81538,1445,기타,2020.05
-2911,0,0,0106901000,2911,34,양서류,2020.05
-895546,0,0,0106903010,895546,67386,갯지렁이,2020.05
-12255,0,0,0106903090,12255,166,기타,2020.05
-29011,0,0,0106909000,29011,686,기타,2020.05
-420289,0,0,0101291000,420289,3000,경주말,2020.06
-244500,0,0,0101299000,244500,4000,기타,2020.06
-568503,0,0,0103100000,568503,26130,번식용,2020.06
-554987,0,0,0105111000,554987,2540,번식용,2020.06
-449738,0,0,0105131000,449738,532,번식용,2020.06
-78409,0,0,0106130000,78409,1690,낙타와 그 밖의 낙타과의 동물[카멜리대(Camelidae)과],2020.06
-75040,0,0,0106149000,75040,1813,기타,2020.06
-8019,383563,5082,0106191000,391582,3438,개,2020.06
-1203493,3325,165,0106199000,1206818,5404,기타,2020.06
-55667,0,0,0106202000,55667,4733,자라,2020.06
-95675,0,0,0106203000,95675,207,거북,2020.06
-70885,0,0,0106209000,70885,212,기타,2020.06
-52723,0,0,0106490000,52723,1152,기타,2020.06
-3351,0,0,0106901000,3351,18,양서류,2020.06
-797842,0,0,0106903010,797842,56946,갯지렁이,2020.06
-2511,0,0,0106903090,2511,282,기타,2020.06
-29544,0,0,0106909000,29544,461,기타,2020.06
-1334986,0,0,0101291000,1334986,12200,경주말,2020.07
419,419,3,0102212000,0,0,육우(肉牛),2020.07
-130538,0,0,0105111000,130538,720,번식용,2020.07
-118077,0,0,0105119000,118077,3242,기타,2020.07
-82016,0,0,0106130000,82016,2005,낙타와 그 밖의 낙타과의 동물[카멜리대(Camelidae)과],2020.07
-61847,0,0,0106149000,61847,1387,기타,2020.07
34681,428740,7742,0106191000,394059,3387,개,2020.07
-1116034,7027,215,0106199000,1123061,4116,기타,2020.07
-2400,0,0,0106201000,2400,2,뱀,2020.07
-58864,0,0,0106202000,58864,5054,자라,2020.07
-123144,166,2,0106203000,123310,292,거북,2020.07
-43783,6952,5,0106209000,50735,102,기타,2020.07
-29814,0,0,0106490000,29814,522,기타,2020.07
-15047,0,0,0106901000,15047,35,양서류,2020.07
-865586,0,0,0106903010,865586,61020,갯지렁이,2020.07
-14510,0,0,0106903090,14510,24,기타,2020.07
-18611,0,0,0106909000,18611,304,기타,2020.07
-1603423,0,0,0101291000,1603423,18850,경주말,2020.08
-122171,0,0,0101299000,122171,2500,기타,2020.08
-47763,0,0,0103920000,47763,2200,중량이 50킬로그램 이상인 것,2020.08
-1984804,0,0,0105111000,1984804,3856,번식용,2020.08
-82786,0,0,0105119000,82786,2514,기타,2020.08
-232291,0,0,0105131000,232291,266,번식용,2020.08
-14346,0,0,0106130000,14346,515,낙타와 그 밖의 낙타과의 동물[카멜리대(Camelidae)과],2020.08
-43010,0,0,0106149000,43010,1100,기타,2020.08
105134,352995,3699,0106191000,247861,2287,개,2020.08
-1041175,15995,303,0106199000,1057170,4685,기타,2020.08
-4020,0,0,0106201000,4020,35,뱀,2020.08
-37639,0,0,0106202000,37639,3092,자라,2020.08
-99877,0,0,0106203000,99877,176,거북,2020.08
-37201,4619,7,0106209000,41820,96,기타,2020.08
-91419,0,0,0106320000,91419,84,앵무류[패럿류(parrots)ㆍ패러키트류(parakeets)ㆍ금강앵무류ㆍ유황앵무류를 포함한다],2020.08
-3041,0,0,0106390000,3041,4,기타,2020.08
-59585,0,0,0106490000,59585,1455,기타,2020.08
-6422,0,0,0106901000,6422,17,양서류,2020.08
-840264,0,0,0106903010,840264,57341,갯지렁이,2020.08
-4267,0,0,0106903090,4267,4,기타,2020.08
-24241,0,0,0106909000,24241,562,기타,2020.08
-1322533,0,0,0101291000,1322533,13000,경주말,2020.09
239,239,2,0102212000,0,0,육우(肉牛),2020.09
-339404,0,0,0105111000,339404,1277,번식용,2020.09
-808275,0,0,0106110000,808275,595,영장류,2020.09
-51607,0,0,0106149000,51607,1106,기타,2020.09
-107989,412859,4696,0106191000,520848,3745,개,2020.09
-1100753,39040,609,0106199000,1139793,4763,기타,2020.09
-6550,0,0,0106201000,6550,7,뱀,2020.09
-31342,0,0,0106202000,31342,2822,자라,2020.09
-78857,0,0,0106203000,78857,148,거북,2020.09
-124006,12877,2,0106209000,136883,201,기타,2020.09
-123105,0,0,0106320000,123105,238,앵무류[패럿류(parrots)ㆍ패러키트류(parakeets)ㆍ금강앵무류ㆍ유황앵무류를 포함한다],2020.09
-129494,0,0,0106490000,129494,4022,기타,2020.09
-23334,0,0,0106901000,23334,36,양서류,2020.09
-1112815,0,0,0106903010,1112815,76219,갯지렁이,2020.09
-6719,0,0,0106903090,6719,13,기타,2020.09
-171796,0,0,0106909000,171796,3280,기타,2020.09
-177500,0,0,0101291000,177500,1500,경주말,2020.10
-302627,0,0,0101299000,302627,3500,기타,2020.10
189,189,2,0102212000,0,0,육우(肉牛),2020.10
-820279,0,0,0103100000,820279,35310,번식용,2020.10
-2360288,0,0,0105111000,2360288,3931,번식용,2020.10
-31457,0,0,0106130000,31457,600,낙타와 그 밖의 낙타과의 동물[카멜리대(Camelidae)과],2020.10
-61628,0,0,0106149000,61628,1301,기타,2020.10
125681,484085,10587,0106191000,358404,2883,개,2020.10
-1066256,98004,1095,0106199000,1164260,5439,기타,2020.10
-3400,0,0,0106201000,3400,4,뱀,2020.10
-42850,0,0,0106202000,42850,4129,자라,2020.10
-83903,0,0,0106203000,83903,138,거북,2020.10
-83554,10381,4,0106209000,93935,91,기타,2020.10
-157293,0,0,0106320000,157293,177,앵무류[패럿류(parrots)ㆍ패러키트류(parakeets)ㆍ금강앵무류ㆍ유황앵무류를 포함한다],2020.10
-118924,0,0,0106490000,118924,2730,기타,2020.10
-70418,0,0,0106901000,70418,3769,양서류,2020.10
-1115502,0,0,0106903010,1115502,77162,갯지렁이,2020.10
-852,0,0,0106903020,852,18,실지렁이,2020.10
-10099,0,0,0106903090,10099,14,기타,2020.10
-137993,0,0,0106909000,137993,2284,기타,2020.10
-123638,0,0,0101291000,123638,3000,경주말,2020.11
-46161,0,0,0101299000,46161,1000,기타,2020.11
-431857,0,0,0102211000,431857,3125,젖소,2020.11
94,94,23,0102212000,0,0,육우(肉牛),2020.11
-2216560,0,0,0106110000,2216560,2315,영장류,2020.11
-88893,0,0,0106122000,88893,130,"물개, 바다사자와 바다코끼리(기각아목의 포유동물)",2020.11
-31561,0,0,0106130000,31561,360,낙타와 그 밖의 낙타과의 동물[카멜리대(Camelidae)과],2020.11
-60390,0,0,0106149000,60390,1473,기타,2020.11
-21449,523440,6075,0106191000,544889,5260,개,2020.11
-1105370,23931,667,0106199000,1129301,4457,기타,2020.11
-3570,0,0,0106201000,3570,80,뱀,2020.11
-55082,0,0,0106202000,55082,4119,자라,2020.11
-145209,0,0,0106203000,145209,216,거북,2020.11
-170345,0,0,0106209000,170345,187,기타,2020.11
-7476,0,0,0106320000,7476,45,앵무류[패럿류(parrots)ㆍ패러키트류(parakeets)ㆍ금강앵무류ㆍ유황앵무류를 포함한다],2020.11
-94482,0,0,0106490000,94482,1985,기타,2020.11
-148227,0,0,0106901000,148227,7096,양서류,2020.11
-731096,0,0,0106903010,731096,49706,갯지렁이,2020.11
-4462,0,0,0106903090,4462,4,기타,2020.11
-162866,0,0,0106909000,162866,1197,기타,2020.11
-659550,0,0,0101211000,659550,3643,농가 사육용,2020.12
-892475,0,0,0101219000,892475,17714,기타,2020.12
-656906,0,0,0101291000,656906,9543,경주말,2020.12
22,22,0,0102212000,0,0,육우(肉牛),2020.12
-90347,0,0,0103100000,90347,7720,번식용,2020.12
-1186520,0,0,0105111000,1186520,3261,번식용,2020.12
-110261,0,0,0106149000,110261,2579,기타,2020.12
96969,629519,4278,0106191000,532550,3821,개,2020.12
-66800,0,0,0106194000,66800,349,곰,2020.12
-1090710,68482,544,0106199000,1159192,4869,기타,2020.12
-101356,0,0,0106201000,101356,101,뱀,2020.12
-45900,0,0,0106202000,45900,2962,자라,2020.12
-26553,0,0,0106203000,26553,88,거북,2020.12
-51114,4829,11,0106209000,55943,104,기타,2020.12
-83307,0,0,0106490000,83307,2968,기타,2020.12
-206717,0,0,0106901000,206717,8565,양서류,2020.12
-504921,0,0,0106903010,504921,34456,갯지렁이,2020.12
-19988,0,0,0106903090,19988,33,기타,2020.12
-91340,0,0,0106909000,91340,1253,기타,2020.12
-64944089,4594187,58340,-,69538276,1176339,-,총계
-572400,0,0,0101291000,572400,6500,경주말,2021.01
-48736,0,0,0103920000,48736,1410,중량이 50킬로그램 이상인 것,2021.01
-1539466,0,0,0105111000,1539466,5027,번식용,2021.01
-101385,0,0,0106149000,101385,2554,기타,2021.01
17189,476781,3428,0106191000,459592,2744,개,2021.01
-865700,14880,304,0106199000,880580,4670,기타,2021.01
-23313,0,0,0106201000,23313,45,뱀,2021.01
-44048,0,0,0106202000,44048,2608,자라,2021.01
-66349,0,0,0106203000,66349,128,거북,2021.01
-12228,58551,25,0106209000,70779,151,기타,2021.01
-99634,0,0,0106490000,99634,4047,기타,2021.01
-213708,0,0,0106901000,213708,7655,양서류,2021.01
-311708,0,0,0106903010,311708,20542,갯지렁이,2021.01
-190,0,0,0106903090,190,2,기타,2021.01
-47734,0,0,0106909000,47734,1073,기타,2021.01
221356,255600,1150,0101291000,34244,1000,경주말,2021.02
-53426,0,0,0106149000,53426,1445,기타,2021.02
76335,545673,3234,0106191000,469338,3334,개,2021.02
-831842,13460,291,0106199000,845302,3276,기타,2021.02
-13120,0,0,0106201000,13120,69,뱀,2021.02
-73974,0,0,0106202000,73974,5200,자라,2021.02
-62613,0,0,0106203000,62613,191,거북,2021.02
3360,72035,40,0106209000,68675,129,기타,2021.02
164,164,1,0106320000,0,0,앵무류[패럿류(parrots)ㆍ패러키트류(parakeets)ㆍ금강앵무류ㆍ유황앵무류를 포함한다],2021.02
-111665,0,0,0106490000,111665,2734,기타,2021.02
-85657,0,0,0106901000,85657,2543,양서류,2021.02
-525059,0,0,0106903010,525059,35932,갯지렁이,2021.02
-19291,0,0,0106903090,19291,20,기타,2021.02
-100043,0,0,0106909000,100043,1366,기타,2021.02
-357909,0,0,0101291000,357909,4000,경주말,2021.03
-1371153,0,0,0101299000,1371153,16500,기타,2021.03
99,99,1,0102212000,0,0,육우(肉牛),2021.03
-102600,0,0,0103100000,102600,3475,번식용,2021.03
-1491496,0,0,0105111000,1491496,4292,번식용,2021.03
-1054000,0,0,0106110000,1054000,605,영장류,2021.03
-99511,0,0,0106149000,99511,2355,기타,2021.03
-45768,580337,4301,0106191000,626105,4242,개,2021.03
-1238211,16434,430,0106199000,1254645,5026,기타,2021.03
-70023,146,9,0106201000,70169,82,뱀,2021.03
-118776,0,0,0106202000,118776,7666,자라,2021.03
-76446,0,0,0106203000,76446,214,거북,2021.03
-190798,83230,115,0106209000,274028,267,기타,2021.03
-130792,0,0,0106490000,130792,5817,기타,2021.03
-26029,0,0,0106901000,26029,1086,양서류,2021.03
-569785,0,0,0106903010,569785,39256,갯지렁이,2021.03
-11089,0,0,0106903090,11089,8,기타,2021.03
-79848,0,0,0106909000,79848,1338,기타,2021.03
-785275,0,0,0101291000,785275,3900,경주말,2021.04
-301384,0,0,0101299000,301384,5500,기타,2021.04
19,19,0,0102212000,0,0,육우(肉牛),2021.04
-1551607,0,0,0105111000,1551607,4001,번식용,2021.04
-34745,0,0,0106130000,34745,1008,낙타와 그 밖의 낙타과의 동물[카멜리대(Camelidae)과],2021.04
-78344,0,0,0106149000,78344,1677,기타,2021.04
-129941,586964,3672,0106191000,716905,4253,개,2021.04
-1278895,35383,435,0106199000,1314278,4500,기타,2021.04
-29147,0,0,0106201000,29147,120,뱀,2021.04
-85277,0,0,0106202000,85277,5997,자라,2021.04
-42799,0,0,0106203000,42799,162,거북,2021.04
26971,173279,93,0106209000,146308,174,기타,2021.04
-127123,0,0,0106490000,127123,4062,기타,2021.04
-15090,0,0,0106901000,15090,72,양서류,2021.04
-777782,0,0,0106903010,777782,51463,갯지렁이,2021.04
-78248,0,0,0106909000,78248,1325,기타,2021.04
7,7,0,0101219000,0,0,기타,2021.05
-291715,0,0,0101291000,291715,3500,경주말,2021.05
-927167,0,0,0103100000,927167,38095,번식용,2021.05
-38519,0,0,0103920000,38519,2210,중량이 50킬로그램 이상인 것,2021.05
30600,30600,230,0105111000,0,0,번식용,2021.05
-67086,82,5,0106149000,67168,1576,기타,2021.05
-130389,507414,7630,0106191000,637803,3917,개,2021.05
-1053109,43507,563,0106199000,1096616,3537,기타,2021.05
-47885,182,5,0106201000,48067,84,뱀,2021.05
-54789,0,0,0106202000,54789,3715,자라,2021.05
-22570,2000,1,0106203000,24570,104,거북,2021.05
76521,193973,151,0106209000,117452,196,기타,2021.05
-83039,0,0,0106490000,83039,1507,기타,2021.05
-10928,0,0,0106901000,10928,82,양서류,2021.05
-811219,0,0,0106903010,811219,54199,갯지렁이,2021.05
-285,0,0,0106903090,285,3,기타,2021.05
-41667,0,0,0106909000,41667,759,기타,2021.05
-597514,0,0,0101291000,597514,3700,경주말,2021.06
-717473,0,0,0103100000,717473,36850,번식용,2021.06
-1202112,0,0,0105111000,1202112,2375,번식용,2021.06
4500,4500,700,0105941000,0,0,번식용,2021.06
-100297,132,5,0106149000,100429,2022,기타,2021.06
147673,632520,3168,0106191000,484847,3410,개,2021.06
-861596,30269,425,0106199000,891865,3183,기타,2021.06
-37566,0,0,0106201000,37566,42,뱀,2021.06
-60805,0,0,0106202000,60805,5587,자라,2021.06
-127451,3000,2,0106203000,130451,439,거북,2021.06
57938,203279,146,0106209000,145341,190,기타,2021.06
-69679,0,0,0106490000,69679,1344,기타,2021.06
-17552,0,0,0106901000,17552,39,양서류,2021.06
-921977,0,0,0106903010,921977,58658,갯지렁이,2021.06
-4460,0,0,0106903020,4460,500,실지렁이,2021.06
-17880,0,0,0106903090,17880,28,기타,2021.06
-29674,0,0,0106909000,29674,416,기타,2021.06
12,12,0,0101219000,0,0,기타,2021.07
-263998,0,0,0101291000,263998,5000,경주말,2021.07
-275954,0,0,0101299000,275954,5000,기타,2021.07
-271392,0,0,0103100000,271392,6841,번식용,2021.07
-68465,0,0,0103920000,68465,5059,중량이 50킬로그램 이상인 것,2021.07
97,97,1,0104209000,0,0,기타,2021.07
-1455644,26760,209,0105111000,1482404,3864,번식용,2021.07
-39259,0,0,0106122000,39259,180,"물개, 바다사자와 바다코끼리(기각아목의 포유동물)",2021.07
-95075,0,0,0106149000,95075,1503,기타,2021.07
105439,495198,2633,0106191000,389759,2972,개,2021.07
-1067160,13654,255,0106199000,1080814,3604,기타,2021.07
-27169,995,2,0106201000,28164,61,뱀,2021.07
-40824,0,0,0106202000,40824,3597,자라,2021.07
-138219,0,0,0106203000,138219,272,거북,2021.07
24323,79002,128,0106209000,54679,119,기타,2021.07
-41569,0,0,0106490000,41569,934,기타,2021.07
-4000,0,0,0106901000,4000,22,양서류,2021.07
-843269,0,0,0106903010,843269,52839,갯지렁이,2021.07
-1165,0,0,0106903020,1165,8,실지렁이,2021.07
-12634,0,0,0106903090,12634,7,기타,2021.07
-20667,0,0,0106909000,20667,361,기타,2021.07
50,50,0,0101219000,0,0,기타,2021.08
-101514,0,0,0101291000,101514,2000,경주말,2021.08
-123920,0,0,0101299000,123920,1700,기타,2021.08
-2280155,17100,114,0105111000,2297255,9754,번식용,2021.08
-65120,0,0,0106149000,65120,1622,기타,2021.08
95117,427970,1658,0106191000,332853,2152,개,2021.08
-1157597,11035,383,0106199000,1168632,3120,기타,2021.08
-30392,499,1,0106201000,30891,46,뱀,2021.08
-35609,0,0,0106202000,35609,3327,자라,2021.08
-206922,8648,15,0106203000,215570,320,거북,2021.08
-144,62809,87,0106209000,62953,142,기타,2021.08
-15417,0,0,0106310000,15417,21,맹금류,2021.08
-83512,0,0,0106490000,83512,2073,기타,2021.08
-12638,0,0,0106901000,12638,38,양서류,2021.08
-887626,0,0,0106903010,887626,51626,갯지렁이,2021.08
-957,0,0,0106903020,957,7,실지렁이,2021.08
-50032,0,0,0106909000,50032,1142,기타,2021.08
55,55,0,0101219000,0,0,기타,2021.09
-32439,0,0,0101291000,32439,1500,경주말,2021.09
18,18,0,0102212000,0,0,육우(肉牛),2021.09
24,24,0,0104209000,0,0,기타,2021.09
-756805,0,0,0105111000,756805,1763,번식용,2021.09
-767800,0,0,0106110000,767800,838,영장류,2021.09
-61851,0,0,0106149000,61851,1659,기타,2021.09
222966,472250,1682,0106191000,249284,2404,개,2021.09
-1393191,19598,444,0106199000,1412789,3957,기타,2021.09
-36669,11510,13,0106201000,48179,95,뱀,2021.09
-24473,0,0,0106202000,24473,1999,자라,2021.09
-88914,0,0,0106203000,88914,245,거북,2021.09
-15408,83766,86,0106209000,99174,168,기타,2021.09
-100730,0,0,0106320000,100730,199,앵무류[패럿류(parrots)ㆍ패러키트류(parakeets)ㆍ금강앵무류ㆍ유황앵무류를 포함한다],2021.09
-102934,0,0,0106490000,102934,1969,기타,2021.09
-13371,0,0,0106901000,13371,122,양서류,2021.09
-1270667,0,0,0106903010,1270667,73148,갯지렁이,2021.09
-17061,0,0,0106903090,17061,17,기타,2021.09
-165530,0,0,0106909000,165530,3467,기타,2021.09
-1248417,0,0,0101291000,1248417,2500,경주말,2021.10
-66560,0,0,0101299000,66560,3000,기타,2021.10
11,11,0,0101309000,0,0,기타,2021.10
-158400,0,0,0103100000,158400,9900,번식용,2021.10
-66662,0,0,0103920000,66662,1830,중량이 50킬로그램 이상인 것,2021.10
112,112,1,0104109000,0,0,기타,2021.10
-286445,0,0,0105111000,286445,1147,번식용,2021.10
-105660,0,0,0106110000,105660,58,영장류,2021.10
-43379,415,20,0106149000,43794,1366,기타,2021.10
389594,551167,1734,0106191000,161573,1693,개,2021.10
-1309558,32269,441,0106199000,1341827,4606,기타,2021.10
-57518,0,0,0106201000,57518,80,뱀,2021.10
-56332,0,0,0106202000,56332,4301,자라,2021.10
-126230,0,0,0106203000,126230,228,거북,2021.10
-167578,127110,88,0106209000,294688,299,기타,2021.10
-55638,0,0,0106320000,55638,51,앵무류[패럿류(parrots)ㆍ패러키트류(parakeets)ㆍ금강앵무류ㆍ유황앵무류를 포함한다],2021.10
-139122,6,1,0106490000,139128,2926,기타,2021.10
-28596,0,0,0106901000,28596,75,양서류,2021.10
-947221,0,0,0106903010,947221,63946,갯지렁이,2021.10
-15211,0,0,0106903090,15211,8,기타,2021.10
-172796,0,0,0106909000,172796,2298,기타,2021.10
278,278,2,0101219000,0,0,기타,2021.11
-418611,0,0,0101291000,418611,2000,경주말,2021.11
-137507,0,0,0101299000,137507,2000,기타,2021.11
124,124,2,0102212000,0,0,육우(肉牛),2021.11
-823518,0,0,0103100000,823518,30880,번식용,2021.11
-29451,0,0,0103920000,29451,1000,중량이 50킬로그램 이상인 것,2021.11
12,12,0,0104209000,0,0,기타,2021.11
-1215034,0,0,0105111000,1215034,1862,번식용,2021.11
-248030,0,0,0105131000,248030,305,번식용,2021.11
-1069800,0,0,0106110000,1069800,655,영장류,2021.11
-69217,0,0,0106149000,69217,2140,기타,2021.11
273961,633524,2806,0106191000,359563,2871,개,2021.11
-1285336,30091,483,0106199000,1315427,4620,기타,2021.11
-78814,9001,5,0106201000,87815,111,뱀,2021.11
-61489,227,1,0106202000,61716,4684,자라,2021.11
-142547,83,1,0106203000,142630,324,거북,2021.11
-28781,153473,72,0106209000,182254,272,기타,2021.11
-99588,0,0,0106320000,99588,64,앵무류[패럿류(parrots)ㆍ패러키트류(parakeets)ㆍ금강앵무류ㆍ유황앵무류를 포함한다],2021.11
-4989,0,0,0106390000,4989,28,기타,2021.11
-116449,0,0,0106490000,116449,1735,기타,2021.11
-24640,0,0,0106901000,24640,81,양서류,2021.11
-547949,0,0,0106903010,547949,40495,갯지렁이,2021.11
-142326,0,0,0106909000,142326,1103,기타,2021.11
-94850,0,0,0101211000,94850,1500,농가 사육용,2021.12
-42712,208,3,0101219000,42920,500,기타,2021.12
-1284396,0,0,0101291000,1284396,12225,경주말,2021.12
-376725,85,1,0101299000,376810,6600,기타,2021.12
54,54,1,0101309000,0,0,기타,2021.12
20,20,1,0101900000,0,0,기타,2021.12
-475000,0,0,0102211000,475000,2296,젖소,2021.12
-209960,0,0,0103100000,209960,17000,번식용,2021.12
-1490197,0,0,0105111000,1490197,3514,번식용,2021.12
-1396680,0,0,0106110000,1396680,903,영장류,2021.12
-6638,0,0,0106122000,6638,180,"물개, 바다사자와 바다코끼리(기각아목의 포유동물)",2021.12
-58852,0,0,0106149000,58852,1495,기타,2021.12
15294,562548,2418,0106191000,547254,3690,개,2021.12
-22039,0,0,0106195090,22039,10,기타,2021.12
-1401081,12474,245,0106199000,1413555,3845,기타,2021.12
-41870,145,1,0106201000,42015,91,뱀,2021.12
-28139,0,0,0106202000,28139,2560,자라,2021.12
-73078,0,0,0106203000,73078,142,거북,2021.12
-90912,39507,60,0106209000,130419,252,기타,2021.12
-72820,0,0,0106320000,72820,70,앵무류[패럿류(parrots)ㆍ패러키트류(parakeets)ㆍ금강앵무류ㆍ유황앵무류를 포함한다],2021.12
-63656,0,0,0106490000,63656,1232,기타,2021.12
-495817,0,0,0106901000,495817,25918,양서류,2021.12
-346841,0,0,0106903010,346841,25016,갯지렁이,2021.12
-14450,0,0,0106903090,14450,19,기타,2021.12
-46733,0,0,0106909000,46733,393,기타,2021.12
-59023996,8448494,46655,-,67472490,1104976,-,총계
-38330,0,0,0101211000,38330,1117,농가 사육용,2022.01
-66391,109,2,0101219000,66500,3400,기타,2022.01
-1210711,0,0,0101299000,1210711,15828,기타,2022.01
30,30,1,0102212000,0,0,육우(肉牛),2022.01
-1044330,0,0,0105111000,1044330,2505,번식용,2022.01
-59559,0,0,0106149000,59559,1657,기타,2022.01
113113,511917,3918,0106191000,398804,2625,개,2022.01
-1014705,37037,620,0106199000,1051742,5650,기타,2022.01
-6468,0,0,0106201000,6468,9,뱀,2022.01
-49605,0,0,0106202000,49605,3910,자라,2022.01
-61628,0,0,0106203000,61628,157,거북,2022.01
193,62545,73,0106209000,62352,72,기타,2022.01
-57958,0,0,0106320000,57958,62,앵무류[패럿류(parrots)ㆍ패러키트류(parakeets)ㆍ금강앵무류ㆍ유황앵무류를 포함한다],2022.01
0,0,10,0106410000,0,0,벌,2022.01
-72744,0,0,0106490000,72744,1933,기타,2022.01
-138079,0,0,0106901000,138079,7034,양서류,2022.01
-434379,0,0,0106903010,434379,30576,갯지렁이,2022.01
-595,0,0,0106903020,595,7,실지렁이,2022.01
-3427,0,0,0106903090,3427,8,기타,2022.01
-43792,0,0,0106909000,43792,638,기타,2022.01
-225526,0,0,0101211000,225526,2700,농가 사육용,2022.02
109,109,1,0101219000,0,0,기타,2022.02
-194379,0,0,0101291000,194379,3500,경주말,2022.02
-373141,0,0,0101299000,373141,6650,기타,2022.02
-424765,0,0,0103100000,424765,33774,번식용,2022.02
-30488,83,3,0106149000,30571,910,기타,2022.02
-65353,489073,2179,0106191000,554426,4146,개,2022.02
-1285223,25227,447,0106199000,1310450,4584,기타,2022.02
-71030,0,0,0106201000,71030,84,뱀,2022.02
-66035,0,0,0106202000,66035,5234,자라,2022.02
-95558,0,0,0106203000,95558,118,거북,2022.02
-135982,15335,25,0106209000,151317,222,기타,2022.02
-22132,0,0,0106320000,22132,14,앵무류[패럿류(parrots)ㆍ패러키트류(parakeets)ㆍ금강앵무류ㆍ유황앵무류를 포함한다],2022.02
-85625,0,0,0106490000,85625,2154,기타,2022.02
-51705,0,0,0106901000,51705,1874,양서류,2022.02
-290268,0,0,0106903010,290268,20630,갯지렁이,2022.02
-22434,0,0,0106903090,22434,12,기타,2022.02
-72749,0,0,0106909000,72749,1218,기타,2022.02
-60950,0,0,0101211000,60950,450,농가 사육용,2022.03
124,124,0,0101219000,0,0,기타,2022.03
-1691331,0,0,0101291000,1691331,8250,경주말,2022.03
-42494,0,0,0101299000,42494,1500,기타,2022.03
7,7,0,0102212000,0,0,육우(肉牛),2022.03
-2307925,0,0,0105111000,2307925,3709,번식용,2022.03
-58144,0,0,0106149000,58144,1553,기타,2022.03
40775,533738,2407,0106191000,492963,3299,개,2022.03
79792,79792,2200,0106194000,0,0,곰,2022.03
-1744458,21074,387,0106199000,1765532,7085,기타,2022.03
-19792,0,0,0106201000,19792,28,뱀,2022.03
-48889,0,0,0106202000,48889,4494,자라,2022.03
-43989,0,0,0106203000,43989,167,거북,2022.03
-145197,140339,114,0106209000,285536,284,기타,2022.03
-100025,0,0,0106490000,100025,2644,기타,2022.03
-11673,0,0,0106901000,11673,41,양서류,2022.03
-466518,0,0,0106903010,466518,31953,갯지렁이,2022.03
-7791,0,0,0106903020,7791,35,실지렁이,2022.03
-8369,0,0,0106903090,8369,8,기타,2022.03
-75139,0,0,0106909000,75139,1048,기타,2022.03
68,68,1,0101219000,0,0,기타,2022.04
-32869,0,0,0101291000,32869,1000,경주말,2022.04
-254767,0,0,0101299000,254767,3500,기타,2022.04
41,41,1,0102212000,0,0,육우(肉牛),2022.04
-113086,0,0,0103100000,113086,6000,번식용,2022.04
-24475,0,0,0103910000,24475,512,중량이 50킬로그램 미만인 것,2022.04
-47614,84,2,0106149000,47698,1377,기타,2022.04
31342,438219,2094,0106191000,406877,2924,개,2022.04
-1409948,25563,328,0106199000,1435511,4625,기타,2022.04
-37892,0,0,0106201000,37892,81,뱀,2022.04
-49623,0,0,0106202000,49623,4547,자라,2022.04
-71890,2876,12,0106203000,74766,123,거북,2022.04
-322724,70391,70,0106209000,393115,394,기타,2022.04
-77914,0,0,0106320000,77914,90,앵무류[패럿류(parrots)ㆍ패러키트류(parakeets)ㆍ금강앵무류ㆍ유황앵무류를 포함한다],2022.04
-145009,0,0,0106490000,145009,2205,기타,2022.04
-25044,0,0,0106901000,25044,83,양서류,2022.04
-715223,11172,144,0106903010,726395,49004,갯지렁이,2022.04
-4103,0,0,0106903090,4103,15,기타,2022.04
-52289,0,0,0106909000,52289,885,기타,2022.04
138,138,1,0101219000,0,0,기타,2022.05
-245050,0,0,0101291000,245050,3000,경주말,2022.05
-776367,0,0,0101299000,776367,9750,기타,2022.05
1035,1035,9,0102212000,0,0,육우(肉牛),2022.05
-346923,0,0,0103100000,346923,21000,번식용,2022.05
13627,13627,345,0105111000,0,0,번식용,2022.05
-56304,0,0,0106149000,56304,1747,기타,2022.05
302000,485590,2026,0106191000,183590,1760,개,2022.05
-1304082,24630,486,0106199000,1328712,3379,기타,2022.05
-8466,0,0,0106201000,8466,24,뱀,2022.05
-41944,0,0,0106202000,41944,3696,자라,2022.05
-94080,0,0,0106203000,94080,208,거북,2022.05
-123552,194617,79,0106209000,318169,372,기타,2022.05
-117491,0,0,0106490000,117491,1838,기타,2022.05
-47514,0,0,0106901000,47514,169,양서류,2022.05
-773396,9678,98,0106903010,783074,49657,갯지렁이,2022.05
-545,0,0,0106903020,545,5,실지렁이,2022.05
-58204,0,0,0106909000,58204,831,기타,2022.05
92,92,2,0101219000,0,0,기타,2022.06
-79946,0,0,0101291000,79946,1500,경주말,2022.06
17,17,0,0101299000,0,0,기타,2022.06
487,487,2,0102212000,0,0,육우(肉牛),2022.06
-490858,0,0,0103100000,490858,23630,번식용,2022.06
-70706,0,0,0103920000,70706,3090,중량이 50킬로그램 이상인 것,2022.06
-1328468,0,0,0105111000,1328468,2414,번식용,2022.06
-54517,0,0,0106149000,54517,1875,기타,2022.06
-190822,415864,1447,0106191000,606686,4030,개,2022.06
-1516504,15069,307,0106199000,1531573,3834,기타,2022.06
-58993,0,0,0106201000,58993,107,뱀,2022.06
-48101,0,0,0106202000,48101,4472,자라,2022.06
-60857,24,1,0106203000,60881,185,거북,2022.06
-250030,154694,154,0106209000,404724,562,기타,2022.06
-82114,0,0,0106320000,82114,90,앵무류[패럿류(parrots)ㆍ패러키트류(parakeets)ㆍ금강앵무류ㆍ유황앵무류를 포함한다],2022.06
-44648,0,0,0106490000,44648,1067,기타,2022.06
-22424,0,0,0106901000,22424,36,양서류,2022.06
-768724,4117,43,0106903010,772841,44798,갯지렁이,2022.06
-35651,0,0,0106909000,35651,415,기타,2022.06
163,163,3,0101219000,0,0,기타,2022.07
-1542294,0,0,0101291000,1542294,19500,경주말,2022.07
-541587,0,0,0101299000,541587,6550,기타,2022.07
28,28,1,0102212000,0,0,육우(肉牛),2022.07
-836805,0,0,0105111000,836805,1379,번식용,2022.07
-53166,0,0,0106130000,53166,720,낙타와 그 밖의 낙타과의 동물[카멜리대(Camelidae)과],2022.07
-89729,169,3,0106149000,89898,2866,기타,2022.07
79473,413276,1278,0106191000,333803,3408,개,2022.07
-895844,17587,426,0106199000,913431,3318,기타,2022.07
-13206,0,0,0106201000,13206,48,뱀,2022.07
-46800,0,0,0106202000,46800,4114,자라,2022.07
-105518,1562,8,0106203000,107080,141,거북,2022.07
-248992,46029,67,0106209000,295021,329,기타,2022.07
-52188,0,0,0106320000,52188,19,앵무류[패럿류(parrots)ㆍ패러키트류(parakeets)ㆍ금강앵무류ㆍ유황앵무류를 포함한다],2022.07
-56134,0,0,0106490000,56134,1186,기타,2022.07
-9434,0,0,0106901000,9434,16,양서류,2022.07
-772835,4839,50,0106903010,777674,46857,갯지렁이,2022.07
-5353,0,0,0106903090,5353,3,기타,2022.07
-28314,0,0,0106909000,28314,340,기타,2022.07
82,82,1,0101219000,0,0,기타,2022.08
-367135,0,0,0101291000,367135,1500,경주말,2022.08
-81601,0,0,0101299000,81601,1500,기타,2022.08
180,180,4,0102212000,0,0,육우(肉牛),2022.08
85,85,0,0104109000,0,0,기타,2022.08
-639803,16800,120,0105111000,656603,1022,번식용,2022.08
-65693,0,0,0106149000,65693,2224,기타,2022.08
-74503,401535,1037,0106191000,476038,3637,개,2022.08
-1137312,13925,323,0106199000,1151237,3394,기타,2022.08
-50199,0,0,0106201000,50199,47,뱀,2022.08
-34208,0,0,0106202000,34208,3449,자라,2022.08
-51927,0,0,0106203000,51927,139,거북,2022.08
-96921,34525,42,0106209000,131446,225,기타,2022.08
-67701,0,0,0106490000,67701,1512,기타,2022.08
-20928,0,0,0106901000,20928,24,양서류,2022.08
-876702,4056,50,0106903010,880758,52213,갯지렁이,2022.08
-16140,0,0,0106903090,16140,11,기타,2022.08
-46050,0,0,0106909000,46050,849,기타,2022.08
195,195,1,0101219000,0,0,기타,2022.09
-615505,0,0,0101291000,615505,3500,경주말,2022.09
21,21,2,0102212000,0,0,육우(肉牛),2022.09
33,33,0,0104209000,0,0,기타,2022.09
-1373144,0,0,0105111000,1373144,2220,번식용,2022.09
-157258,0,0,0106130000,157258,5076,낙타와 그 밖의 낙타과의 동물[카멜리대(Camelidae)과],2022.09
-49886,0,0,0106149000,49886,1598,기타,2022.09
65452,422642,1290,0106191000,357190,2862,개,2022.09
3321,3321,20,0106196090,0,0,기타,2022.09
-1411086,16401,389,0106199000,1427487,3130,기타,2022.09
-19912,8410,5,0106201000,28322,91,뱀,2022.09
-32213,0,0,0106202000,32213,2987,자라,2022.09
-68305,0,0,0106203000,68305,83,거북,2022.09
-250405,23247,44,0106209000,273652,469,기타,2022.09
-120735,0,0,0106490000,120735,2588,기타,2022.09
-19158,0,0,0106901000,19158,169,양서류,2022.09
-892154,3266,34,0106903010,895420,55647,갯지렁이,2022.09
-393,0,0,0106903090,393,6,기타,2022.09
-131163,0,0,0106909000,131163,2849,기타,2022.09
65,65,1,0101219000,0,0,기타,2022.10
-691534,0,0,0101291000,691534,9000,경주말,2022.10
-38551,0,0,0101299000,38551,1500,기타,2022.10
-413000,0,0,0102211000,413000,2744,젖소,2022.10
375,375,5,0102212000,0,0,육우(肉牛),2022.10
-292258,0,0,0103100000,292258,1500,번식용,2022.10
-176570,0,0,0103920000,176570,10100,중량이 50킬로그램 이상인 것,2022.10
-1115467,0,0,0105111000,1115467,1164,번식용,2022.10
-1297500,0,0,0106110000,1297500,640,영장류,2022.10
-37393,0,0,0106149000,37393,1358,기타,2022.10
107467,447122,2463,0106191000,339655,2667,개,2022.10
-1253630,19554,329,0106199000,1273184,3236,기타,2022.10
-13771,0,0,0106201000,13771,21,뱀,2022.10
-37601,0,0,0106202000,37601,3585,자라,2022.10
-95785,0,0,0106203000,95785,113,거북,2022.10
88168,349545,112,0106209000,261377,141,기타,2022.10
-145999,0,0,0106490000,145999,2671,기타,2022.10
-78495,0,0,0106901000,78495,3545,양서류,2022.10
-635779,1652,18,0106903010,637431,49019,갯지렁이,2022.10
-17594,0,0,0106903090,17594,14,기타,2022.10
-178037,0,0,0106909000,178037,2452,기타,2022.10
-1230800,0,0,0101299000,1230800,7000,기타,2022.11
16,16,1,0101900000,0,0,기타,2022.11
-557511,0,0,0103100000,557511,25000,번식용,2022.11
-60479,0,0,0103920000,60479,1780,중량이 50킬로그램 이상인 것,2022.11
-4952,0,0,0104109000,4952,280,기타,2022.11
137,137,1,0104209000,0,0,기타,2022.11
-884374,0,0,0105111000,884374,4647,번식용,2022.11
-41592,86,3,0106149000,41678,1267,기타,2022.11
-134184,380340,1346,0106191000,514524,3110,개,2022.11
-1351738,13228,259,0106199000,1364966,3924,기타,2022.11
-68246,13276,15,0106201000,81522,60,뱀,2022.11
-28424,0,0,0106202000,28424,2705,자라,2022.11
-33382,19350,9,0106203000,52732,40,거북,2022.11
-237804,62550,100,0106209000,300354,318,기타,2022.11
-11068,0,0,0106320000,11068,25,앵무류[패럿류(parrots)ㆍ패러키트류(parakeets)ㆍ금강앵무류ㆍ유황앵무류를 포함한다],2022.11
-101001,0,0,0106490000,101001,1748,기타,2022.11
-257461,0,0,0106901000,257461,12244,양서류,2022.11
-528095,190,2,0106903010,528285,42462,갯지렁이,2022.11
-140329,0,0,0106909000,140329,1147,기타,2022.11
-30865,0,0,0101211000,30865,1400,농가 사육용,2022.12
192,192,8,0101219000,0,0,기타,2022.12
-287705,107395,1150,0101291000,395100,6500,경주말,2022.12
-2432255,2,0,0101299000,2432257,45100,기타,2022.12
1243399,1243399,23880,0102211000,0,0,젖소,2022.12
-599612,0,0,0103100000,599612,15160,번식용,2022.12
215,215,1,0104209000,0,0,기타,2022.12
-1524677,30800,220,0105111000,1555477,3196,번식용,2022.12
-59435,0,0,0106149000,59435,2104,기타,2022.12
156806,437306,1532,0106191000,280500,2142,개,2022.12
-1147487,17050,290,0106199000,1164537,4219,기타,2022.12
-148949,7686,3,0106201000,156635,172,뱀,2022.12
-25019,0,0,0106202000,25019,2429,자라,2022.12
-13980,0,0,0106203000,13980,38,거북,2022.12
-55389,61266,71,0106209000,116655,169,기타,2022.12
-6849,0,0,0106320000,6849,20,앵무류[패럿류(parrots)ㆍ패러키트류(parakeets)ㆍ금강앵무류ㆍ유황앵무류를 포함한다],2022.12
-70229,0,0,0106490000,70229,1718,기타,2022.12
-368567,0,0,0106901000,368567,14145,양서류,2022.12
-234805,0,0,0106903010,234805,19148,갯지렁이,2022.12
-17032,0,0,0106903090,17032,12,기타,2022.12
-63373,0,0,0106909000,63373,473,기타,2022.12
-58143637,8429806,57057,-,66573443,1065647,-,총계
418,418,20,0101219000,0,0,기타,2023.01
-468708,10000,550,0101291000,478708,6553,경주말,2023.01
-215031,0,0,0101299000,215031,3000,기타,2023.01
11,11,0,0102212000,0,0,육우(肉牛),2023.01
374,374,2,0104209000,0,0,기타,2023.01
-1706265,0,0,0105111000,1706265,4360,번식용,2023.01
-1156289,0,0,0105131000,1156289,221,번식용,2023.01
-2640500,0,0,0106110000,2640500,505,영장류,2023.01
-37684,0,0,0106149000,37684,1187,기타,2023.01
153553,470123,1491,0106191000,316570,2435,개,2023.01
-919892,15805,327,0106199000,935697,2774,기타,2023.01
-4106,3854,18,0106201000,7960,17,뱀,2023.01
-45568,0,0,0106202000,45568,4010,자라,2023.01
-32968,0,0,0106203000,32968,77,거북,2023.01
63274,107639,113,0106209000,44365,63,기타,2023.01
-101844,0,0,0106490000,101844,2574,기타,2023.01
-159031,0,0,0106901000,159031,7438,양서류,2023.01
-224135,0,0,0106903010,224135,17860,갯지렁이,2023.01
-48606,0,0,0106909000,48606,410,기타,2023.01
729,729,21,0101219000,0,0,기타,2023.02
1165377,1200000,1500,0101291000,34623,500,경주말,2023.02
-199404,0,0,0101299000,199404,2700,기타,2023.02
-211632,0,0,0103100000,211632,14362,번식용,2023.02
-468450,0,0,0105111000,468450,1932,번식용,2023.02
-39994,84,3,0106149000,40078,1348,기타,2023.02
165890,517073,1281,0106191000,351183,2660,개,2023.02
-746602,12295,239,0106199000,758897,2525,기타,2023.02
-3077,0,0,0106201000,3077,11,뱀,2023.02
-37707,0,0,0106202000,37707,3706,자라,2023.02
-76935,22367,16,0106203000,99302,341,거북,2023.02
-30710,28839,79,0106209000,59549,111,기타,2023.02
-141817,0,0,0106490000,141817,3290,기타,2023.02
-36048,0,0,0106901000,36048,2931,양서류,2023.02
-305113,0,0,0106903010,305113,24898,갯지렁이,2023.02
-50,0,0,0106903020,50,2,실지렁이,2023.02
-17000,0,0,0106903090,17000,351,기타,2023.02
-65676,0,0,0106909000,65676,639,기타,2023.02
147,147,10,0101219000,0,0,기타,2023.03
-843563,0,0,0101291000,843563,4950,경주말,2023.03
-1038464,0,0,0101299000,1038464,12500,기타,2023.03
346487,346487,1886,0102211000,0,0,젖소,2023.03
194,194,2,0102212000,0,0,육우(肉牛),2023.03
-434650,0,0,0103100000,434650,29892,번식용,2023.03
-71971,0,0,0103920000,71971,2000,중량이 50킬로그램 이상인 것,2023.03
226,226,1,0104209000,0,0,기타,2023.03
-1566538,16030,115,0105111000,1582568,2092,번식용,2023.03
-178474,0,0,0105131000,178474,223,번식용,2023.03
-550000,0,0,0106110000,550000,600,영장류,2023.03
-45401,169,4,0106149000,45570,1510,기타,2023.03
32239,541662,4472,0106191000,509423,3623,개,2023.03
-1058350,26029,333,0106199000,1084379,3071,기타,2023.03
-12462,3147,6,0106201000,15609,36,뱀,2023.03
-38018,0,0,0106202000,38018,3616,자라,2023.03
-67467,0,0,0106203000,67467,167,거북,2023.03
164633,305855,138,0106209000,141222,269,기타,2023.03
-124359,0,0,0106490000,124359,2982,기타,2023.03
-26571,570,1,0106901000,27141,1545,양서류,2023.03
-476155,0,0,0106903010,476155,40384,갯지렁이,2023.03
-28595,0,0,0106903090,28595,139,기타,2023.03
-62869,0,0,0106909000,62869,973,기타,2023.03
70,70,4,0101219000,0,0,기타,2023.04
-359525,0,0,0101291000,359525,2500,경주말,2023.04
-159093,0,0,0101299000,159093,1500,기타,2023.04
-630353,0,0,0103100000,630353,44150,번식용,2023.04
407,407,2,0104109000,0,0,기타,2023.04
172,172,1,0104209000,0,0,기타,2023.04
-1158651,0,0,0105111000,1158651,2563,번식용,2023.04
167,167,1,0105999000,0,0,기타,2023.04
-1467500,0,0,0106110000,1467500,634,영장류,2023.04
-30612,0,0,0106130000,30612,750,낙타와 그 밖의 낙타과의 동물[카멜리대(Camelidae)과],2023.04
-52639,0,0,0106149000,52639,1719,기타,2023.04
287359,501106,1498,0106191000,213747,1471,개,2023.04
-1021783,10704,105,0106199000,1032487,3029,기타,2023.04
-18677,450,2,0106201000,19127,31,뱀,2023.04
-32711,0,0,0106202000,32711,2805,자라,2023.04
-31483,140,3,0106203000,31623,308,거북,2023.04
104276,198601,207,0106209000,94325,233,기타,2023.04
-90811,0,0,0106490000,90811,1561,기타,2023.04
-20629,2652,9,0106901000,23281,1282,양서류,2023.04
-470412,0,0,0106903010,470412,35653,갯지렁이,2023.04
-6819,0,0,0106903020,6819,100,실지렁이,2023.04
-2286,0,0,0106903090,2286,193,기타,2023.04
-50524,0,0,0106909000,50524,878,기타,2023.04
-19883254,4344596,14457,-,24227850,327723,-,총계
